,level_0,index,date,user,change_amt,year,running_count
0,0,6162,2007-04-16 15:16:00,Taoster,107,2007,107
1,1,5921,2007-04-16 15:19:00,GhostPirate,253,2007,360
2,2,5920,2007-04-16 15:21:00,GhostPirate,35,2007,395
3,3,5919,2007-04-16 15:28:00,Yellowbuddy,0,2007,395
4,4,6157,2007-04-16 15:29:00,GhostPirate,121,2007,516
5,5,5918,2007-04-16 15:29:00,Yellowbuddy,183,2007,699
6,6,6155,2007-04-16 15:30:00,Yellowbuddy,0,2007,699
7,7,6156,2007-04-16 15:30:00,GhostPirate,1,2007,700
8,8,6154,2007-04-16 15:32:00,Yellowbuddy,67,2007,767
9,9,6153,2007-04-16 15:33:00,GhostPirate,158,2007,925
10,10,6152,2007-04-16 15:34:00,GhostPirate,1,2007,926
11,11,6151,2007-04-16 15:35:00,GhostPirate,-20,2007,906
12,12,6149,2007-04-16 15:37:00,RHB,0,2007,906
13,13,5910,2007-04-16 15:37:00,PSUMark2006,22,2007,928
14,14,5908,2007-04-16 15:46:00,Rxnd,6,2007,934
15,15,5907,2007-04-16 15:47:00,Rxnd,50,2007,984
16,16,5906,2007-04-16 15:49:00,PGPirate,100,2007,1084
17,17,5905,2007-04-16 15:50:00,B,74,2007,1158
18,18,5904,2007-04-16 15:52:00,Zachary,56,2007,1214
19,19,5903,2007-04-16 15:57:00,Bmoore2009,218,2007,1432
20,20,6142,2007-04-16 16:03:00,Bmoore2009,176,2007,1608
21,21,6141,2007-04-16 16:04:00,PSUMark2006,2,2007,1610
22,22,6140,2007-04-16 16:05:00,Bmoore2009,-3,2007,1607
23,23,6139,2007-04-16 16:09:00,Verdafolio,267,2007,1874
24,24,5898,2007-04-16 16:11:00,Verdafolio,-2,2007,1872
25,25,5897,2007-04-16 16:14:00,Bmoore2009,-7,2007,1865
26,26,5896,2007-04-16 16:15:00,208.111.194.85,0,2007,1865
27,27,6135,2007-04-16 16:16:00,FPAtl,52,2007,1917
28,28,5894,2007-04-16 16:18:00,Verdafolio,-1,2007,1916
29,29,5893,2007-04-16 16:18:00,PSUMark2006,97,2007,2013
30,31,5890,2007-04-16 16:19:00,Verdafolio,1,2007,2014
31,32,5891,2007-04-16 16:19:00,Jopgaard,67,2007,2081
32,30,5892,2007-04-16 16:19:00,Verdafolio,133,2007,2214
33,33,6129,2007-04-16 16:20:00,Verdafolio,-67,2007,2147
34,34,6127,2007-04-16 16:22:00,PSUMark2006,56,2007,2203
35,35,5888,2007-04-16 16:22:00,PSUMark2006,137,2007,2340
36,36,6126,2007-04-16 16:23:00,PSUMark2006,0,2007,2340
37,37,6125,2007-04-16 16:23:00,Verdafolio,4,2007,2344
38,38,6124,2007-04-16 16:23:00,Igafooj,16,2007,2360
39,39,6123,2007-04-16 16:24:00,Igafooj,-2,2007,2358
40,40,5882,2007-04-16 16:26:00,Verdafolio,155,2007,2513
41,41,5881,2007-04-16 16:28:00,Verdafolio,43,2007,2556
42,42,5880,2007-04-16 16:28:00,TexasDawg,79,2007,2635
43,43,5879,2007-04-16 16:30:00,Verdafolio,197,2007,2832
44,44,5877,2007-04-16 16:31:00,Verdafolio,46,2007,2878
45,45,5878,2007-04-16 16:31:00,Verdafolio,2,2007,2880
46,46,6116,2007-04-16 16:33:00,67.189.157.69,14,2007,2894
47,47,5875,2007-04-16 16:34:00,161.107.18.136,-58,2007,2836
48,48,5874,2007-04-16 16:34:00,161.107.18.136,-4,2007,2832
49,49,6112,2007-04-16 16:35:00,72.92.32.15,20,2007,2852
50,50,6113,2007-04-16 16:35:00,160.254.108.24,26,2007,2878
51,52,6110,2007-04-16 16:38:00,Verdafolio,253,2007,3131
52,53,6111,2007-04-16 16:38:00,Kizor,-17,2007,3114
53,51,6109,2007-04-16 16:38:00,Verdafolio,5,2007,3119
54,54,6108,2007-04-16 16:40:00,Timothyarnold85,-10,2007,3109
55,55,5867,2007-04-16 16:40:00,Verdafolio,173,2007,3282
56,56,5866,2007-04-16 16:40:00,KazakhPol,0,2007,3282
57,57,5865,2007-04-16 16:40:00,Verdafolio,-5,2007,3277
58,61,5863,2007-04-16 16:41:00,Verdafolio,21,2007,3298
59,58,5864,2007-04-16 16:41:00,71.213.237.121,20,2007,3318
60,59,5862,2007-04-16 16:41:00,Timothyarnold85,1,2007,3319
61,60,5861,2007-04-16 16:41:00,Verdafolio,29,2007,3348
62,64,5857,2007-04-16 16:42:00,129.174.173.67,189,2007,3537
63,65,5860,2007-04-16 16:42:00,72.92.32.15,-2,2007,3535
64,62,5859,2007-04-16 16:42:00,PRRfan,-19,2007,3516
65,63,5858,2007-04-16 16:42:00,Timothyarnold85,-4,2007,3512
66,66,6096,2007-04-16 16:43:00,Kizor,-49,2007,3463
67,67,5853,2007-04-16 16:43:00,Fethers,37,2007,3500
68,68,5854,2007-04-16 16:43:00,AEMoreira042281,-140,2007,3360
69,69,5855,2007-04-16 16:43:00,Timothyarnold85,-37,2007,3323
70,74,5851,2007-04-16 16:44:00,AEMoreira042281,6,2007,3329
71,73,5850,2007-04-16 16:44:00,129.174.173.67,38,2007,3367
72,75,5852,2007-04-16 16:44:00,161.107.18.136,0,2007,3367
73,71,5847,2007-04-16 16:44:00,DwayneP,69,2007,3436
74,70,6088,2007-04-16 16:44:00,AEMoreira042281,-39,2007,3397
75,72,5849,2007-04-16 16:44:00,AEMoreira042281,26,2007,3423
76,76,5846,2007-04-16 16:45:00,Timothyarnold85,-29,2007,3394
77,77,5845,2007-04-16 16:45:00,129.174.173.67,45,2007,3439
78,78,5844,2007-04-16 16:45:00,AEMoreira042281,-69,2007,3370
79,79,5843,2007-04-16 16:46:00,Ernie at Tedium,3,2007,3373
80,80,5842,2007-04-16 16:47:00,129.174.173.67,76,2007,3449
81,81,5840,2007-04-16 16:48:00,Darry2385,-85,2007,3364
82,82,5841,2007-04-16 16:48:00,129.174.173.67,9,2007,3373
83,83,5839,2007-04-16 16:49:00,Dhartung,3,2007,3376
84,84,6078,2007-04-16 16:49:00,AEMoreira042281,10,2007,3386
85,86,6076,2007-04-16 16:50:00,Nishkid64,0,2007,3386
86,85,6077,2007-04-16 16:50:00,129.174.173.67,55,2007,3441
87,88,5835,2007-04-16 16:51:00,71.213.237.121,16,2007,3457
88,89,5833,2007-04-16 16:51:00,Fethers,-54,2007,3403
89,87,5834,2007-04-16 16:51:00,John Stattic,65,2007,3468
90,90,5832,2007-04-16 16:52:00,Timothyarnold85,-262,2007,3206
91,91,5831,2007-04-16 16:53:00,Timothyarnold85,-1,2007,3205
92,92,5830,2007-04-16 16:53:00,The wub,2,2007,3207
93,93,5829,2007-04-16 16:54:00,Daysleeper47,228,2007,3435
94,94,6066,2007-04-16 16:55:00,Timothyarnold85,310,2007,3745
95,95,6064,2007-04-16 16:55:00,AEMoreira042281,-109,2007,3636
96,96,5828,2007-04-16 16:55:00,Verdafolio,20,2007,3656
97,97,5827,2007-04-16 16:55:00,Elliskev,158,2007,3814
98,98,5825,2007-04-16 16:55:00,71.213.237.121,110,2007,3924
99,103,6063,2007-04-16 16:56:00,131.111.100.155,-1,2007,3923
100,102,6062,2007-04-16 16:56:00,Timothyarnold85,-20,2007,3903
101,100,5821,2007-04-16 16:56:00,69.156.168.238,67,2007,3970
102,99,6059,2007-04-16 16:56:00,Trampikey,-7,2007,3963
103,101,6060,2007-04-16 16:56:00,71.213.237.121,110,2007,4073
104,104,6054,2007-04-16 16:57:00,HappyCamper,13,2007,4086
105,105,5818,2007-04-16 16:57:00,Wjmoore17,-95,2007,3991
106,106,5817,2007-04-16 16:57:00,Verdafolio,138,2007,4129
107,107,5816,2007-04-16 16:57:00,Elliskev,26,2007,4155
108,108,5815,2007-04-16 16:57:00,Timothyarnold85,5,2007,4160
109,109,5813,2007-04-16 16:57:00,Daysleeper47,21,2007,4181
110,114,5810,2007-04-16 16:58:00,PRRfan,-32,2007,4149
111,115,5808,2007-04-16 16:58:00,Timothyarnold85,0,2007,4149
112,113,5811,2007-04-16 16:58:00,Kizor,187,2007,4336
113,111,6049,2007-04-16 16:58:00,Kizor,-2,2007,4334
114,110,6047,2007-04-16 16:58:00,68.175.108.175,8,2007,4342
115,112,5812,2007-04-16 16:58:00,HappyCamper,-27,2007,4315
116,116,5806,2007-04-16 16:59:00,J 1982,43,2007,4358
117,117,5805,2007-04-16 16:59:00,69.156.168.238,0,2007,4358
118,118,6043,2007-04-16 17:00:00,PRRfan,-2,2007,4356
119,119,5802,2007-04-16 17:00:00,Kizor,137,2007,4493
120,120,6044,2007-04-16 17:00:00,PRRfan,-49,2007,4444
121,123,6038,2007-04-16 17:01:00,71.213.237.121,125,2007,4569
122,124,6039,2007-04-16 17:01:00,71.64.206.248,75,2007,4644
123,122,5800,2007-04-16 17:01:00,PRRfan,-12,2007,4632
124,121,6041,2007-04-16 17:01:00,Timothyarnold85,0,2007,4632
125,125,6034,2007-04-16 17:02:00,Majorly,16,2007,4648
126,126,6035,2007-04-16 17:02:00,Ali'i,-8,2007,4640
127,127,6036,2007-04-16 17:02:00,Majorly,0,2007,4640
128,128,6037,2007-04-16 17:02:00,Rst20xx,-2,2007,4638
129,129,6033,2007-04-16 17:03:00,PRRfan,-124,2007,4514
130,130,6030,2007-04-16 17:03:00,Timothyarnold85,0,2007,4514
131,131,6031,2007-04-16 17:03:00,Nishkid64,-138,2007,4376
132,135,6029,2007-04-16 17:04:00,PRRfan,-36,2007,4340
133,134,6028,2007-04-16 17:04:00,Trampikey,46,2007,4386
134,133,6027,2007-04-16 17:04:00,PRRfan,2,2007,4388
135,132,6026,2007-04-16 17:04:00,Bdj,8,2007,4396
136,136,5785,2007-04-16 17:05:00,Timothyarnold85,2,2007,4398
137,137,6024,2007-04-16 17:07:00,Timothyarnold85,-46,2007,4352
138,138,5782,2007-04-16 17:08:00,Nedtyler,15,2007,4367
139,139,5783,2007-04-16 17:08:00,President David Palmer,-2,2007,4365
140,140,5779,2007-04-16 17:09:00,Timothyarnold85,-9,2007,4356
141,141,6020,2007-04-16 17:09:00,Trampikey,1,2007,4357
142,142,5781,2007-04-16 17:09:00,Kizor,83,2007,4440
143,145,6016,2007-04-16 17:10:00,Kizor,34,2007,4474
144,146,6015,2007-04-16 17:10:00,Bueller 007,53,2007,4527
145,143,6018,2007-04-16 17:10:00,Kizor,-34,2007,4493
146,144,6017,2007-04-16 17:10:00,Trampikey,6,2007,4499
147,147,5772,2007-04-16 17:11:00,Timothyarnold85,4,2007,4503
148,148,5774,2007-04-16 17:11:00,Floaterfluss,58,2007,4561
149,149,5771,2007-04-16 17:11:00,PRRfan,-4,2007,4557
150,150,5773,2007-04-16 17:11:00,PRRfan,14,2007,4571
151,151,5768,2007-04-16 17:12:00,PRRfan,2,2007,4573
152,152,5770,2007-04-16 17:12:00,Daysleeper47,0,2007,4573
153,153,6009,2007-04-16 17:12:00,Trampikey,86,2007,4659
154,154,6007,2007-04-16 17:14:00,Alias777,4,2007,4663
155,159,6005,2007-04-16 17:15:00,Zehly,129,2007,4792
156,160,6006,2007-04-16 17:15:00,Sveter,31,2007,4823
157,158,6004,2007-04-16 17:15:00,Trampikey,7,2007,4830
158,156,6002,2007-04-16 17:15:00,Jarsonic,90,2007,4920
159,155,6001,2007-04-16 17:15:00,Moncrief,8,2007,4928
160,157,6003,2007-04-16 17:15:00,Jambalaya~enwiki,8,2007,4936
161,161,5760,2007-04-16 17:16:00,Ebutuoyf2f2,0,2007,4936
162,162,5759,2007-04-16 17:16:00,Ali'i,-8,2007,4928
163,163,5758,2007-04-16 17:16:00,John Stattic,-99,2007,4829
164,164,5997,2007-04-16 17:17:00,Jarsonic,33,2007,4862
165,165,5995,2007-04-16 17:17:00,John Stattic,-8,2007,4854
166,166,5756,2007-04-16 17:17:00,TexasDawg,-123,2007,4731
167,168,5993,2007-04-16 17:18:00,Trampikey,-148,2007,4583
168,167,5754,2007-04-16 17:18:00,HappyCamper,1,2007,4584
169,169,5752,2007-04-16 17:19:00,BoxingNut83,-112,2007,4472
170,170,5751,2007-04-16 17:19:00,PRRfan,18,2007,4490
171,171,5989,2007-04-16 17:20:00,Kizor,258,2007,4748
172,172,5746,2007-04-16 17:20:00,John Stattic,-250,2007,4498
173,173,5990,2007-04-16 17:20:00,BoxingNut83,-9,2007,4489
174,174,5988,2007-04-16 17:20:00,Kizor,-156,2007,4333
175,175,5987,2007-04-16 17:20:00,Dsims209,0,2007,4333
176,176,5985,2007-04-16 17:21:00,Verdafolio,-252,2007,4081
177,177,5984,2007-04-16 17:21:00,PRRfan,-4,2007,4077
178,181,5982,2007-04-16 17:23:00,Umedard,4,2007,4081
179,180,5981,2007-04-16 17:23:00,Decrease789,104,2007,4185
180,182,5983,2007-04-16 17:23:00,PublicSecrecy,217,2007,4402
181,178,5979,2007-04-16 17:23:00,Kizor,259,2007,4661
182,179,5980,2007-04-16 17:23:00,Verdafolio,66,2007,4727
183,183,5977,2007-04-16 17:24:00,Ckatz,0,2007,4727
184,184,5738,2007-04-16 17:24:00,Ali'i,-217,2007,4510
185,185,5976,2007-04-16 17:25:00,Ckatz,4,2007,4514
186,186,5975,2007-04-16 17:25:00,Kizor,-217,2007,4297
187,189,5731,2007-04-16 17:26:00,Jon Ace,20,2007,4317
188,190,5734,2007-04-16 17:26:00,PGPirate,157,2007,4474
189,187,5732,2007-04-16 17:26:00,Fett0001,9,2007,4483
190,188,5733,2007-04-16 17:26:00,HappyCamper,22,2007,4505
191,191,5730,2007-04-16 17:27:00,EnviroGranny,0,2007,4505
192,192,5729,2007-04-16 17:27:00,Jambalaya~enwiki,0,2007,4505
193,193,5728,2007-04-16 17:27:00,Jambalaya~enwiki,-21,2007,4484
194,194,5726,2007-04-16 17:28:00,Jambalaya~enwiki,-157,2007,4327
195,195,5965,2007-04-16 17:28:00,Blakwyte,0,2007,4327
196,196,5727,2007-04-16 17:28:00,THF,86,2007,4413
197,203,5964,2007-04-16 17:29:00,TexasDawg,-256,2007,4157
198,205,5717,2007-04-16 17:29:00,Jambalaya~enwiki,-9,2007,4148
199,204,5716,2007-04-16 17:29:00,PublicSecrecy,41,2007,4189
200,202,5963,2007-04-16 17:29:00,RyzinEnagy,65,2007,4254
201,201,5961,2007-04-16 17:29:00,PublicSecrecy,76,2007,4330
202,200,5960,2007-04-16 17:29:00,TexasDawg,-1,2007,4329
203,199,5959,2007-04-16 17:29:00,Kizor,168,2007,4497
204,198,5958,2007-04-16 17:29:00,Jarsonic,7,2007,4504
205,197,5722,2007-04-16 17:29:00,Jarsonic,1,2007,4505
206,206,5952,2007-04-16 17:30:00,TexasDawg,-173,2007,4332
207,207,5954,2007-04-16 17:30:00,TexasDawg,-1,2007,4331
208,208,5951,2007-04-16 17:30:00,RyzinEnagy,-273,2007,4058
209,209,5953,2007-04-16 17:30:00,Jtalledo,0,2007,4058
210,210,5715,2007-04-16 17:30:00,PublicSecrecy,-114,2007,3944
211,216,5946,2007-04-16 17:31:00,HappyCamper,-1,2007,3943
212,215,5705,2007-04-16 17:31:00,Jtalledo,-9,2007,3934
213,214,5710,2007-04-16 17:31:00,TexasDawg,-105,2007,3829
214,212,5708,2007-04-16 17:31:00,EnviroGranny,-14,2007,3815
215,211,5707,2007-04-16 17:31:00,Jtalledo,9,2007,3824
216,213,5709,2007-04-16 17:31:00,Mike R,-132,2007,3692
217,217,5942,2007-04-16 17:32:00,Ali'i,0,2007,3692
218,218,5943,2007-04-16 17:32:00,Erebus555,1,2007,3693
219,219,5944,2007-04-16 17:32:00,EnviroGranny,20,2007,3713
220,224,5700,2007-04-16 17:33:00,Search4Lancer,-8,2007,3705
221,226,5936,2007-04-16 17:33:00,BoxingNut83,-1,2007,3704
222,223,5695,2007-04-16 17:33:00,EnviroGranny,0,2007,3704
223,225,5701,2007-04-16 17:33:00,Nil Einne,217,2007,3921
224,221,5698,2007-04-16 17:33:00,Kizor,112,2007,4033
225,222,5699,2007-04-16 17:33:00,BoxingNut83,1,2007,4034
226,220,5697,2007-04-16 17:33:00,Mguerard27,23,2007,4057
227,227,5934,2007-04-16 17:34:00,Block1of4,207,2007,4264
228,228,5933,2007-04-16 17:35:00,Kizor,0,2007,4264
229,229,5692,2007-04-16 17:35:00,Daysleeper47,52,2007,4316
230,230,5691,2007-04-16 17:35:00,Jtalledo,-171,2007,4145
231,231,5690,2007-04-16 17:35:00,Alphachimp,0,2007,4145
232,234,5926,2007-04-16 17:36:00,ElKevbo,0,2007,4145
233,235,5927,2007-04-16 17:36:00,Wittylama,9,2007,4154
234,232,5688,2007-04-16 17:36:00,John Stattic,0,2007,4154
235,233,5689,2007-04-16 17:36:00,ElKevbo,75,2007,4229
236,236,5685,2007-04-16 17:37:00,ElKevbo,23,2007,4252
237,237,5684,2007-04-16 17:37:00,John Stattic,-83,2007,4169
238,238,5683,2007-04-16 17:38:00,Ethan,1,2007,4170
239,239,5682,2007-04-16 17:38:00,MPD01605,2,2007,4172
240,240,5681,2007-04-16 17:38:00,Ultrarob,-5,2007,4167
241,241,5680,2007-04-16 17:38:00,John Stattic,-49,2007,4118
242,242,5679,2007-04-16 17:39:00,KeyranC,0,2007,4118
243,243,5678,2007-04-16 17:39:00,Bolivian Unicyclist,73,2007,4191
244,244,5677,2007-04-16 17:40:00,Jarsonic,28,2007,4219
245,245,5676,2007-04-16 17:40:00,Nil Einne,-109,2007,4110
246,249,5672,2007-04-16 17:42:00,Midkay,1,2007,4111
247,248,5673,2007-04-16 17:42:00,Stanley011,0,2007,4111
248,246,5675,2007-04-16 17:42:00,Sesse,5,2007,4116
249,247,5674,2007-04-16 17:42:00,Jmw0000,10,2007,4126
250,250,5668,2007-04-16 17:43:00,OpposingForce,-1,2007,4125
251,251,5670,2007-04-16 17:43:00,OpposingForce,42,2007,4167
252,252,5671,2007-04-16 17:43:00,Djdono,8,2007,4175
253,253,5669,2007-04-16 17:43:00,John Stattic,27,2007,4202
254,254,5667,2007-04-16 17:44:00,John Stattic,-5,2007,4197
255,255,5666,2007-04-16 17:44:00,Robbskey,39,2007,4236
256,256,5665,2007-04-16 17:44:00,Wittylama,-6,2007,4230
257,258,5663,2007-04-16 17:45:00,24fanatics,0,2007,4230
258,257,5664,2007-04-16 17:45:00,Stanley011,0,2007,4230
259,263,5658,2007-04-16 17:46:00,Wittylama,13,2007,4243
260,262,5659,2007-04-16 17:46:00,Threeafterthree,-207,2007,4036
261,259,5662,2007-04-16 17:46:00,Nil Einne,-76,2007,3960
262,260,5661,2007-04-16 17:46:00,Nil Einne,16,2007,3976
263,261,5660,2007-04-16 17:46:00,Stanley011,0,2007,3976
264,266,5657,2007-04-16 17:47:00,Bolivian Unicyclist,6,2007,3982
265,264,5655,2007-04-16 17:47:00,FunPika,34,2007,4016
266,265,5654,2007-04-16 17:47:00,Stanley011,0,2007,4016
267,267,5656,2007-04-16 17:47:00,John Stattic,-113,2007,3903
268,271,5650,2007-04-16 17:48:00,Kingclyde,0,2007,3903
269,270,5651,2007-04-16 17:48:00,Dale Arnett,32,2007,3935
270,272,5649,2007-04-16 17:48:00,24fanatics,-13,2007,3922
271,268,5653,2007-04-16 17:48:00,Stanley011,0,2007,3922
272,269,5652,2007-04-16 17:48:00,24fanatics,49,2007,3971
273,273,5648,2007-04-16 17:49:00,Midkay,96,2007,4067
274,274,5647,2007-04-16 17:49:00,Bolivian Unicyclist,21,2007,4088
275,275,5646,2007-04-16 17:49:00,Gamer112,-150,2007,3938
276,276,5645,2007-04-16 17:49:00,Yaf,5,2007,3943
277,277,5644,2007-04-16 17:49:00,Rjp0i,0,2007,3943
278,278,5643,2007-04-16 17:50:00,Jmw0000,-3,2007,3940
279,279,5642,2007-04-16 17:50:00,Stanley011,0,2007,3940
280,285,5640,2007-04-16 17:51:00,John Reaves,0,2007,3940
281,284,5638,2007-04-16 17:51:00,Justincosio,-32,2007,3908
282,283,5641,2007-04-16 17:51:00,Wittylama,0,2007,3908
283,282,5639,2007-04-16 17:51:00,Alphachimp,-5,2007,3903
284,281,5637,2007-04-16 17:51:00,THF,39,2007,3942
285,280,5636,2007-04-16 17:51:00,Dale Arnett,36,2007,3978
286,286,5635,2007-04-16 17:52:00,ElKevbo,-4,2007,3974
287,287,5634,2007-04-16 17:52:00,Fsu23phd,0,2007,3974
288,288,5633,2007-04-16 17:52:00,DenniZvb,0,2007,3974
289,289,5632,2007-04-16 17:52:00,ElKevbo,7,2007,3981
290,290,5631,2007-04-16 17:52:00,John Reaves,-94,2007,3887
291,295,5627,2007-04-16 17:53:00,Kingclyde,98,2007,3985
292,294,5628,2007-04-16 17:53:00,Dale Arnett,26,2007,4011
293,293,5629,2007-04-16 17:53:00,DenniZvb,0,2007,4011
294,292,5630,2007-04-16 17:53:00,Fsu23phd,0,2007,4011
295,291,5626,2007-04-16 17:53:00,Umedard,0,2007,4011
296,296,5621,2007-04-16 17:54:00,Dale Arnett,65,2007,4076
297,297,5622,2007-04-16 17:54:00,Chrislk02,0,2007,4076
298,298,5625,2007-04-16 17:54:00,Kingclyde,-58,2007,4018
299,299,5624,2007-04-16 17:54:00,4.88.154.133,-11,2007,4007
300,300,5623,2007-04-16 17:54:00,Rjp0i,4,2007,4011
301,303,5618,2007-04-16 17:55:00,Petska~enwiki,1,2007,4012
302,304,5617,2007-04-16 17:55:00,EnviroGranny,31,2007,4043
303,301,5620,2007-04-16 17:55:00,John Stattic,-50,2007,3993
304,302,5619,2007-04-16 17:55:00,Bolivian Unicyclist,20,2007,4013
305,305,5616,2007-04-16 17:56:00,65.199.254.45,159,2007,4172
306,306,5615,2007-04-16 17:56:00,Jmw0000,-3,2007,4169
307,307,5614,2007-04-16 17:56:00,John Stattic,0,2007,4169
308,308,5613,2007-04-16 17:56:00,Chelkey,114,2007,4283
309,309,5612,2007-04-16 17:56:00,John Stattic,11,2007,4294
310,310,5607,2007-04-16 17:57:00,Kizor,-186,2007,4108
311,311,5608,2007-04-16 17:57:00,193.11.196.211,0,2007,4108
312,312,5610,2007-04-16 17:57:00,59.115.99.40,0,2007,4108
313,313,5611,2007-04-16 17:57:00,128.143.70.115,0,2007,4108
314,314,5609,2007-04-16 17:57:00,HappyCamper,25,2007,4133
315,319,5601,2007-04-16 17:58:00,Bfinn,96,2007,4229
316,318,5602,2007-04-16 17:58:00,Mediumemu,69,2007,4298
317,317,5604,2007-04-16 17:58:00,193.11.196.211,0,2007,4298
318,315,5606,2007-04-16 17:58:00,89.241.168.213,6,2007,4304
319,316,5605,2007-04-16 17:58:00,HappyCamper,0,2007,4304
320,320,5598,2007-04-16 17:59:00,67.189.145.208,-69,2007,4235
321,321,5600,2007-04-16 17:59:00,59.115.99.40,0,2007,4235
322,322,5599,2007-04-16 17:59:00,Golbez,0,2007,4235
323,323,5597,2007-04-16 18:00:00,128.180.210.19,0,2007,4235
324,324,5596,2007-04-16 18:00:00,Jon Ace,0,2007,4235
325,325,5595,2007-04-16 18:00:00,74.64.90.177,50,2007,4285
326,326,5594,2007-04-16 18:00:00,Bfinn,1,2007,4286
327,327,5593,2007-04-16 18:00:00,90.193.73.29,0,2007,4286
328,328,5592,2007-04-16 18:00:00,SirFozzie,-296,2007,3990
329,331,5589,2007-04-16 18:01:00,Chelkey,16,2007,4006
330,330,5590,2007-04-16 18:01:00,128.180.210.19,0,2007,4006
331,329,5591,2007-04-16 18:01:00,Halo,72,2007,4078
332,332,5585,2007-04-16 18:02:00,90.193.73.29,1,2007,4079
333,333,5588,2007-04-16 18:02:00,195.184.109.162,0,2007,4079
334,334,5587,2007-04-16 18:02:00,The Badge Man,13,2007,4092
335,335,5586,2007-04-16 18:02:00,Chelkey,11,2007,4103
336,336,5584,2007-04-16 18:03:00,195.184.109.162,0,2007,4103
337,337,5583,2007-04-16 18:03:00,Verdafolio,3,2007,4106
338,338,5582,2007-04-16 18:03:00,68.63.32.21,0,2007,4106
339,339,5581,2007-04-16 18:03:00,59.115.99.40,0,2007,4106
340,345,5577,2007-04-16 18:04:00,Gamer112,107,2007,4213
341,344,5580,2007-04-16 18:04:00,John Stattic,-83,2007,4130
342,343,5578,2007-04-16 18:04:00,Mr Ernie,0,2007,4130
343,341,5576,2007-04-16 18:04:00,T-rex,-47,2007,4083
344,340,5575,2007-04-16 18:04:00,141.109.56.143,-77,2007,4006
345,342,5579,2007-04-16 18:04:00,J. Achilles Troy,8,2007,4014
346,346,5574,2007-04-16 18:05:00,Cloudz679,9,2007,4023
347,347,5573,2007-04-16 18:05:00,137.112.141.137,-2,2007,4021
348,348,5572,2007-04-16 18:05:00,Jmw0000,129,2007,4150
349,349,5571,2007-04-16 18:05:00,Juzz101,84,2007,4234
350,350,5570,2007-04-16 18:05:00,59.115.99.40,26,2007,4260
351,351,5569,2007-04-16 18:05:00,Mr Ernie,0,2007,4260
352,352,5568,2007-04-16 18:05:00,Shawn Pickrell,-2,2007,4258
353,353,5567,2007-04-16 18:05:00,Block1of4,53,2007,4311
354,361,5562,2007-04-16 18:06:00,JerseyDevil26,50,2007,4361
355,360,5566,2007-04-16 18:06:00,Wittylama,-50,2007,4311
356,359,5564,2007-04-16 18:06:00,68.63.32.21,36,2007,4347
357,358,5563,2007-04-16 18:06:00,59.115.99.40,-4,2007,4343
358,354,5558,2007-04-16 18:06:00,89.201.152.133,0,2007,4343
359,356,5560,2007-04-16 18:06:00,Chelkey,26,2007,4369
360,355,5559,2007-04-16 18:06:00,Kingbird1,29,2007,4398
361,357,5565,2007-04-16 18:06:00,Jmw0000,8,2007,4406
362,368,5556,2007-04-16 18:07:00,Block1of4,153,2007,4559
363,369,5553,2007-04-16 18:07:00,81.179.195.34,-15,2007,4544
364,367,5555,2007-04-16 18:07:00,Bfinn,-153,2007,4391
365,366,5554,2007-04-16 18:07:00,Shawn Pickrell,152,2007,4543
366,365,5557,2007-04-16 18:07:00,RyanGerbil10,0,2007,4543
367,364,5552,2007-04-16 18:07:00,66.153.202.150,82,2007,4625
368,363,5550,2007-04-16 18:07:00,76.107.135.187,-1,2007,4624
369,362,5551,2007-04-16 18:07:00,85.146.57.172,13,2007,4637
370,379,5540,2007-04-16 18:08:00,207.127.241.2,0,2007,4637
371,377,5542,2007-04-16 18:08:00,82.136.48.145,0,2007,4637
372,376,5543,2007-04-16 18:08:00,76.107.135.187,-12,2007,4625
373,375,5544,2007-04-16 18:08:00,Jmw0000,34,2007,4659
374,378,5541,2007-04-16 18:08:00,66.153.202.150,-82,2007,4577
375,373,5546,2007-04-16 18:08:00,207.148.211.89,0,2007,4577
376,372,5547,2007-04-16 18:08:00,Silvonen,28,2007,4605
377,371,5548,2007-04-16 18:08:00,85.146.57.172,-1,2007,4604
378,370,5549,2007-04-16 18:08:00,59.115.99.40,-5,2007,4599
379,374,5545,2007-04-16 18:08:00,86.136.172.223,9,2007,4608
380,380,5534,2007-04-16 18:09:00,141.109.56.143,-319,2007,4289
381,381,5535,2007-04-16 18:09:00,76.181.119.245,1,2007,4290
382,382,5536,2007-04-16 18:09:00,Chunky Rice,85,2007,4375
383,383,5537,2007-04-16 18:09:00,59.115.99.40,-53,2007,4322
384,384,5538,2007-04-16 18:09:00,Jmw0000,64,2007,4386
385,385,5539,2007-04-16 18:09:00,207.148.211.89,0,2007,4386
386,392,5527,2007-04-16 18:10:00,Alfiboy,0,2007,4386
387,395,5524,2007-04-16 18:10:00,Block1of4,208,2007,4594
388,394,5525,2007-04-16 18:10:00,Gamer112,112,2007,4706
389,393,5526,2007-04-16 18:10:00,59.115.99.40,29,2007,4735
390,391,5528,2007-04-16 18:10:00,207.148.211.89,0,2007,4735
391,387,5532,2007-04-16 18:10:00,192.223.226.6,-51,2007,4684
392,389,5530,2007-04-16 18:10:00,207.127.241.2,-5,2007,4679
393,388,5531,2007-04-16 18:10:00,70.185.167.115,23,2007,4702
394,386,5533,2007-04-16 18:10:00,BazookaJoe,319,2007,5021
395,390,5529,2007-04-16 18:10:00,69.74.41.252,-17,2007,5004
396,401,5520,2007-04-16 18:11:00,81.179.195.34,100,2007,5104
397,399,5521,2007-04-16 18:11:00,74.70.200.193,-98,2007,5006
398,400,5523,2007-04-16 18:11:00,Jetman,-1,2007,5005
399,397,5519,2007-04-16 18:11:00,59.115.99.40,-3,2007,5002
400,396,5518,2007-04-16 18:11:00,66.153.202.150,119,2007,5121
401,398,5522,2007-04-16 18:11:00,BazookaJoe,-165,2007,4956
402,402,5517,2007-04-16 18:12:00,Abe Lincoln,23,2007,4979
403,403,5516,2007-04-16 18:12:00,75.68.211.103,-245,2007,4734
404,404,5515,2007-04-16 18:12:00,NotThatKat,-1,2007,4733
405,405,5514,2007-04-16 18:12:00,75.68.211.103,-1,2007,4732
406,412,5512,2007-04-16 18:13:00,89.241.168.213,38,2007,4770
407,414,5509,2007-04-16 18:13:00,Bfinn,-2,2007,4768
408,413,5513,2007-04-16 18:13:00,Abe Lincoln,295,2007,5063
409,411,5510,2007-04-16 18:13:00,BazookaJoe,-159,2007,4904
410,409,5508,2007-04-16 18:13:00,JerseyDevil26,50,2007,4954
411,410,5505,2007-04-16 18:13:00,71.13.236.131,121,2007,5075
412,408,5506,2007-04-16 18:13:00,75.68.211.103,0,2007,5075
413,407,5504,2007-04-16 18:13:00,131.94.222.133,0,2007,5075
414,406,5507,2007-04-16 18:13:00,24.163.249.234,114,2007,5189
415,420,5503,2007-04-16 18:14:00,RyanGerbil10,0,2007,5189
416,419,5502,2007-04-16 18:14:00,75.68.211.103,-15,2007,5174
417,418,5501,2007-04-16 18:14:00,68.106.52.235,70,2007,5244
418,421,5500,2007-04-16 18:14:00,BazookaJoe,-70,2007,5174
419,416,5499,2007-04-16 18:14:00,75.68.211.103,-121,2007,5053
420,415,5498,2007-04-16 18:14:00,Alangu,27,2007,5080
421,417,5497,2007-04-16 18:14:00,199.43.32.87,0,2007,5080
422,422,5496,2007-04-16 18:15:00,Jmw0000,41,2007,5121
423,423,5495,2007-04-16 18:15:00,Sonjaaa,23,2007,5144
424,424,5494,2007-04-16 18:15:00,Chunky Rice,13,2007,5157
425,425,5493,2007-04-16 18:15:00,Bfinn,0,2007,5157
426,426,5492,2007-04-16 18:15:00,24.22.124.20,89,2007,5246
427,427,5491,2007-04-16 18:15:00,12.163.10.190,-1,2007,5245
428,428,5490,2007-04-16 18:15:00,Golbez,0,2007,5245
429,434,5487,2007-04-16 18:16:00,Msfwhs,0,2007,5245
430,436,5485,2007-04-16 18:16:00,JerseyDevil26,0,2007,5245
431,435,5488,2007-04-16 18:16:00,Chunky Rice,40,2007,5285
432,432,5486,2007-04-16 18:16:00,RenamedUser jaskldjslak904,0,2007,5285
433,430,5482,2007-04-16 18:16:00,Jmw0000,0,2007,5285
434,431,5484,2007-04-16 18:16:00,Halo,-120,2007,5165
435,429,5483,2007-04-16 18:16:00,Bfinn,-295,2007,4870
436,433,5489,2007-04-16 18:16:00,BazookaJoe,-89,2007,4781
437,437,5481,2007-04-16 18:17:00,Bfinn,1,2007,4782
438,438,5480,2007-04-16 18:17:00,MatthewLiberal,-101,2007,4681
439,439,5478,2007-04-16 18:17:00,Chunky Rice,-8,2007,4673
440,440,5477,2007-04-16 18:17:00,Abe.Froman,10,2007,4683
441,447,5475,2007-04-16 18:18:00,Jmw0000,1,2007,4684
442,446,5473,2007-04-16 18:18:00,MisterHand,1,2007,4685
443,445,5476,2007-04-16 18:18:00,Msfwhs,0,2007,4685
444,442,5471,2007-04-16 18:18:00,JerseyDevil26,0,2007,4685
445,443,5472,2007-04-16 18:18:00,Alfiboy,0,2007,4685
446,441,5470,2007-04-16 18:18:00,BazookaJoe,16,2007,4701
447,444,5474,2007-04-16 18:18:00,Abe Lincoln,16,2007,4717
448,449,5469,2007-04-16 18:19:00,Wittylama,71,2007,4788
449,448,5467,2007-04-16 18:19:00,Jmw0000,25,2007,4813
450,450,5468,2007-04-16 18:19:00,Steevo714,39,2007,4852
451,455,5465,2007-04-16 18:20:00,Dlazzaro,124,2007,4976
452,456,5466,2007-04-16 18:20:00,Kaldari,-60,2007,4916
453,454,5464,2007-04-16 18:20:00,Bfinn,-73,2007,4843
454,457,5463,2007-04-16 18:20:00,Crotalus horridus,-12,2007,4831
455,452,5461,2007-04-16 18:20:00,Abe Lincoln,-94,2007,4737
456,453,5462,2007-04-16 18:20:00,JerseyDevil26,50,2007,4787
457,451,5460,2007-04-16 18:20:00,Chuck Sirloin,-68,2007,4719
458,458,5459,2007-04-16 18:21:00,Dlazzaro,9,2007,4728
459,459,5458,2007-04-16 18:21:00,Zoicon5,-1,2007,4727
460,460,5457,2007-04-16 18:21:00,Musicpvm,-15,2007,4712
461,461,5456,2007-04-16 18:22:00,Kaldari,6,2007,4718
462,462,5455,2007-04-16 18:22:00,John Stattic,8,2007,4726
463,463,5454,2007-04-16 18:22:00,Abe.Froman,24,2007,4750
464,469,5450,2007-04-16 18:23:00,Alfiboy,21,2007,4771
465,467,5451,2007-04-16 18:23:00,Msfwhs,12,2007,4783
466,468,5453,2007-04-16 18:23:00,Jmw0000,108,2007,4891
467,465,5449,2007-04-16 18:23:00,ElKevbo,-20,2007,4871
468,464,5448,2007-04-16 18:23:00,Jmw0000,-4,2007,4867
469,466,5452,2007-04-16 18:23:00,Pepsidrinka,53,2007,4920
470,470,5447,2007-04-16 18:24:00,Pepsidrinka,16,2007,4936
471,471,5446,2007-04-16 18:24:00,ElKevbo,3,2007,4939
472,472,5439,2007-04-16 18:25:00,Kechvsf,-257,2007,4682
473,473,5440,2007-04-16 18:25:00,Halo,9,2007,4691
474,474,5441,2007-04-16 18:25:00,ElKevbo,-54,2007,4637
475,475,5443,2007-04-16 18:25:00,Jmw0000,55,2007,4692
476,476,5444,2007-04-16 18:25:00,Umedard,92,2007,4784
477,477,5445,2007-04-16 18:25:00,Rjp0i,10,2007,4794
478,478,5442,2007-04-16 18:25:00,JerseyDevil26,26,2007,4820
479,481,5436,2007-04-16 18:26:00,Kechvsf,-37,2007,4783
480,479,5438,2007-04-16 18:26:00,Akubhai,38,2007,4821
481,480,5437,2007-04-16 18:26:00,Kechvsf,-22,2007,4799
482,482,5430,2007-04-16 18:27:00,Alangu,53,2007,4852
483,483,5431,2007-04-16 18:27:00,Kaldari,-54,2007,4798
484,484,5432,2007-04-16 18:27:00,Betaeleven,16,2007,4814
485,485,5434,2007-04-16 18:27:00,Ruhe1986,-28,2007,4786
486,486,5435,2007-04-16 18:27:00,ElKevbo,52,2007,4838
487,487,5433,2007-04-16 18:27:00,MPD01605,79,2007,4917
488,491,5426,2007-04-16 18:28:00,Sirex98,1,2007,4918
489,488,5429,2007-04-16 18:28:00,Jmw0000,4,2007,4922
490,489,5428,2007-04-16 18:28:00,Spectheintro,-23,2007,4899
491,490,5427,2007-04-16 18:28:00,ElKevbo,-5,2007,4894
492,492,5423,2007-04-16 18:29:00,Alangu,36,2007,4930
493,493,5425,2007-04-16 18:29:00,Zehly,6,2007,4936
494,494,5424,2007-04-16 18:29:00,Valdoran,-3,2007,4933
495,499,5421,2007-04-16 18:30:00,Alfiboy,0,2007,4933
496,498,5420,2007-04-16 18:30:00,Rjp0i,64,2007,4997
497,500,5419,2007-04-16 18:30:00,Alangu,-36,2007,4961
498,496,5418,2007-04-16 18:30:00,Abe Lincoln,37,2007,4998
499,495,5417,2007-04-16 18:30:00,Pepsidrinka,-6,2007,4992
500,497,5422,2007-04-16 18:30:00,Jmw0000,80,2007,5072
501,502,5415,2007-04-16 18:31:00,Rjoebrandon,39,2007,5111
502,501,5416,2007-04-16 18:31:00,SensenfrauXx,210,2007,5321
503,503,5413,2007-04-16 18:32:00,Jolb,3,2007,5324
504,504,5412,2007-04-16 18:32:00,Kingclyde,38,2007,5362
505,505,5411,2007-04-16 18:32:00,DuKot,0,2007,5362
506,506,5410,2007-04-16 18:32:00,Evileyetmc,-6,2007,5356
507,507,5409,2007-04-16 18:32:00,Swid,48,2007,5404
508,508,5414,2007-04-16 18:32:00,Kizor,0,2007,5404
509,509,5408,2007-04-16 18:33:00,Abe.Froman,259,2007,5663
510,510,5407,2007-04-16 18:33:00,Thejerm,0,2007,5663
511,513,5406,2007-04-16 18:34:00,Kechvsf,-161,2007,5502
512,512,5405,2007-04-16 18:34:00,Jmw0000,0,2007,5502
513,511,5404,2007-04-16 18:34:00,Noclip,6,2007,5508
514,514,5403,2007-04-16 18:35:00,Akubhai,27,2007,5535
515,515,5402,2007-04-16 18:35:00,MPD01605,0,2007,5535
516,516,5401,2007-04-16 18:35:00,Umedard,4,2007,5539
517,517,5400,2007-04-16 18:35:00,Swid,32,2007,5571
518,518,5399,2007-04-16 18:35:00,Zehly,96,2007,5667
519,519,5398,2007-04-16 18:35:00,Friskysman,-170,2007,5497
520,524,5393,2007-04-16 18:36:00,John Stattic,2,2007,5499
521,523,5394,2007-04-16 18:36:00,Erciesielski,5,2007,5504
522,525,5392,2007-04-16 18:36:00,Rjoebrandon,167,2007,5671
523,521,5396,2007-04-16 18:36:00,Trebor,0,2007,5671
524,520,5397,2007-04-16 18:36:00,Search4Lancer,76,2007,5747
525,522,5395,2007-04-16 18:36:00,StarScarsCeiling,-1,2007,5746
526,526,5391,2007-04-16 18:37:00,Itsfullofstars,121,2007,5867
527,527,5390,2007-04-16 18:37:00,Fourthords,0,2007,5867
528,528,5386,2007-04-16 18:38:00,Mithent,83,2007,5950
529,529,5388,2007-04-16 18:38:00,SillyWalksMinister,22,2007,5972
530,530,5389,2007-04-16 18:38:00,Nyttend,20,2007,5992
531,531,5387,2007-04-16 18:38:00,Qmax,-2,2007,5990
532,541,5382,2007-04-16 18:39:00,Rjoebrandon,111,2007,6101
533,540,5380,2007-04-16 18:39:00,RMThompson,343,2007,6444
534,539,5383,2007-04-16 18:39:00,Nyttend,-1,2007,6443
535,538,5381,2007-04-16 18:39:00,Betaeleven,-110,2007,6333
536,537,5385,2007-04-16 18:39:00,Search4Lancer,67,2007,6400
537,535,5378,2007-04-16 18:39:00,Mike Fields,0,2007,6400
538,534,5377,2007-04-16 18:39:00,John Stattic,-176,2007,6224
539,533,5376,2007-04-16 18:39:00,Search4Lancer,-68,2007,6156
540,532,5384,2007-04-16 18:39:00,Trebor,139,2007,6295
541,536,5379,2007-04-16 18:39:00,Mithent,6,2007,6301
542,542,5375,2007-04-16 18:40:00,RMThompson,2,2007,6303
543,543,5374,2007-04-16 18:40:00,Mithent,-1,2007,6302
544,544,5373,2007-04-16 18:40:00,Betaeleven,8,2007,6310
545,545,5372,2007-04-16 18:40:00,Mtowers,0,2007,6310
546,550,5371,2007-04-16 18:41:00,Eric.frederich,-168,2007,6142
547,551,5369,2007-04-16 18:41:00,Trebor,170,2007,6312
548,549,5370,2007-04-16 18:41:00,Betaeleven,21,2007,6333
549,547,5368,2007-04-16 18:41:00,Search4Lancer,0,2007,6333
550,548,5366,2007-04-16 18:41:00,HappyCamper,-343,2007,5990
551,546,5367,2007-04-16 18:41:00,Betaeleven,8,2007,5998
552,552,5365,2007-04-16 18:42:00,Zehly,18,2007,6016
553,553,5364,2007-04-16 18:42:00,HappyCamper,-3,2007,6013
554,554,5363,2007-04-16 18:42:00,Semper331fi,-47,2007,5966
555,555,5362,2007-04-16 18:42:00,Mithent,-89,2007,5877
556,556,5361,2007-04-16 18:42:00,ElKevbo,-57,2007,5820
557,557,5360,2007-04-16 18:42:00,Rpgman456,36,2007,5856
558,558,5359,2007-04-16 18:42:00,Akubhai,-97,2007,5759
559,562,5358,2007-04-16 18:43:00,Mrzaius,12,2007,5771
560,561,5357,2007-04-16 18:43:00,ElKevbo,-111,2007,5660
561,559,5355,2007-04-16 18:43:00,Eric.frederich,-52,2007,5608
562,560,5356,2007-04-16 18:43:00,ElKevbo,-96,2007,5512
563,563,5354,2007-04-16 18:44:00,Dputig07,51,2007,5563
564,564,5353,2007-04-16 18:44:00,Mtowers,-1,2007,5562
565,565,5352,2007-04-16 18:44:00,Mithent,87,2007,5649
566,566,5351,2007-04-16 18:45:00,ElKevbo,-22,2007,5627
567,567,5350,2007-04-16 18:46:00,TexasDawg,-62,2007,5565
568,568,5349,2007-04-16 18:46:00,Ferr,23,2007,5588
569,569,5348,2007-04-16 18:46:00,Mike Fields,54,2007,5642
570,570,5347,2007-04-16 18:46:00,Sirex98,0,2007,5642
571,574,5344,2007-04-16 18:47:00,Sam 1123,0,2007,5642
572,573,5345,2007-04-16 18:47:00,Dwilliams617,2,2007,5644
573,572,5346,2007-04-16 18:47:00,Cgonsalves,-8,2007,5636
574,571,5343,2007-04-16 18:47:00,Zehly,-58,2007,5578
575,575,5342,2007-04-16 18:48:00,Betaeleven,18,2007,5596
576,576,5341,2007-04-16 18:48:00,Ferr,17,2007,5613
577,577,5340,2007-04-16 18:48:00,Jmw0000,-61,2007,5552
578,578,5335,2007-04-16 18:49:00,SillyWalksMinister,0,2007,5552
579,579,5336,2007-04-16 18:49:00,Semper331fi,10,2007,5562
580,580,5334,2007-04-16 18:49:00,Sam 1123,-8,2007,5554
581,581,5338,2007-04-16 18:49:00,CorinneQ,0,2007,5554
582,582,5337,2007-04-16 18:49:00,Kevinp2,46,2007,5600
583,583,5339,2007-04-16 18:49:00,Dposse,-2,2007,5598
584,586,5333,2007-04-16 18:50:00,Jaksmata,1,2007,5599
585,584,5331,2007-04-16 18:50:00,Hoopesk2,1,2007,5600
586,585,5332,2007-04-16 18:50:00,Wittylama,-264,2007,5336
587,587,5330,2007-04-16 18:51:00,Fourthords,-41,2007,5295
588,588,5329,2007-04-16 18:51:00,Dwilliams617,59,2007,5354
589,589,5328,2007-04-16 18:51:00,Dposse,-2,2007,5352
590,590,5327,2007-04-16 18:51:00,Jmw0000,81,2007,5433
591,591,5325,2007-04-16 18:51:00,Markie,1,2007,5434
592,596,5324,2007-04-16 18:52:00,ElKevbo,264,2007,5698
593,597,5322,2007-04-16 18:52:00,John Stattic,17,2007,5715
594,595,5323,2007-04-16 18:52:00,Jmw0000,-83,2007,5632
595,593,5321,2007-04-16 18:52:00,ElKevbo,-49,2007,5583
596,594,5320,2007-04-16 18:52:00,CorinneQ,0,2007,5583
597,592,5319,2007-04-16 18:52:00,Nyttend,22,2007,5605
598,598,5318,2007-04-16 18:53:00,Markie,43,2007,5648
599,599,5317,2007-04-16 18:53:00,ElKevbo,-3,2007,5645
600,600,5316,2007-04-16 18:53:00,Starks,5,2007,5650
601,601,5315,2007-04-16 18:53:00,Wittylama,-32,2007,5618
602,602,5314,2007-04-16 18:53:00,Dposse,-61,2007,5557
603,603,5313,2007-04-16 18:53:00,Chardish,1,2007,5558
604,610,5312,2007-04-16 18:54:00,Fourthords,-41,2007,5517
605,609,5309,2007-04-16 18:54:00,Dcandeto,0,2007,5517
606,608,5311,2007-04-16 18:54:00,Jmw0000,-110,2007,5407
607,604,5306,2007-04-16 18:54:00,Markie,0,2007,5407
608,606,5308,2007-04-16 18:54:00,Cnota,18,2007,5425
609,605,5307,2007-04-16 18:54:00,PRRfan,-18,2007,5407
610,607,5310,2007-04-16 18:54:00,Mike Fields,-59,2007,5348
611,612,5305,2007-04-16 18:55:00,PRRfan,-19,2007,5329
612,611,5304,2007-04-16 18:55:00,99th Percentile,112,2007,5441
613,616,5300,2007-04-16 18:56:00,Markie,0,2007,5441
614,615,5301,2007-04-16 18:56:00,Threeafterthree,-7,2007,5434
615,613,5303,2007-04-16 18:56:00,Georgiapatio,2,2007,5436
616,614,5302,2007-04-16 18:56:00,Martin 00792,12,2007,5448
617,617,5299,2007-04-16 18:57:00,Catalogingeek,83,2007,5531
618,618,5297,2007-04-16 18:57:00,Mike Fields,7,2007,5538
619,619,5298,2007-04-16 18:57:00,Abe Lincoln,-21,2007,5517
620,620,5296,2007-04-16 18:58:00,Neo-Jay,2,2007,5519
621,621,5295,2007-04-16 18:58:00,Jmw0000,61,2007,5580
622,622,5294,2007-04-16 18:58:00,PRRfan,3,2007,5583
623,624,5293,2007-04-16 18:59:00,Dposse,104,2007,5687
624,623,5290,2007-04-16 18:59:00,PRRfan,-49,2007,5638
625,625,5292,2007-04-16 18:59:00,PRRfan,-35,2007,5603
626,626,5291,2007-04-16 18:59:00,John Reaves,0,2007,5603
627,627,5289,2007-04-16 19:00:00,Wittylama,248,2007,5851
628,628,5288,2007-04-16 19:00:00,Kaldari,-9,2007,5842
629,632,5286,2007-04-16 19:01:00,Ckeady,212,2007,6054
630,631,5283,2007-04-16 19:01:00,Dcandeto,0,2007,6054
631,633,5285,2007-04-16 19:01:00,Halo,37,2007,6091
632,629,5287,2007-04-16 19:01:00,PRRfan,-22,2007,6069
633,630,5282,2007-04-16 19:01:00,Jmw0000,38,2007,6107
634,634,5284,2007-04-16 19:01:00,Mike Fields,0,2007,6107
635,640,5276,2007-04-16 19:02:00,Kaldari,10,2007,6117
636,641,5275,2007-04-16 19:02:00,156.75.192.109,-1,2007,6116
637,639,5277,2007-04-16 19:02:00,Zenohockey,19,2007,6135
638,638,5278,2007-04-16 19:02:00,ElKevbo,-129,2007,6006
639,637,5279,2007-04-16 19:02:00,156.75.192.109,46,2007,6052
640,636,5280,2007-04-16 19:02:00,Theragu40,24,2007,6076
641,635,5281,2007-04-16 19:02:00,Catalogingeek,48,2007,6124
642,646,5273,2007-04-16 19:03:00,TerraFrost,0,2007,6124
643,645,5272,2007-04-16 19:03:00,Chunky Rice,16,2007,6140
644,647,5271,2007-04-16 19:03:00,147.241.40.2,-28,2007,6112
645,643,5270,2007-04-16 19:03:00,147.241.40.2,1,2007,6113
646,642,5269,2007-04-16 19:03:00,Chunky Rice,-4,2007,6109
647,644,5274,2007-04-16 19:03:00,Cnota,7,2007,6116
648,648,5262,2007-04-16 19:04:00,Cnota,56,2007,6172
649,649,5264,2007-04-16 19:04:00,Zehly,18,2007,6190
650,650,5263,2007-04-16 19:04:00,12.72.53.253,57,2007,6247
651,651,5266,2007-04-16 19:04:00,Woodworthjohn,105,2007,6352
652,652,5268,2007-04-16 19:04:00,Akubhai,1,2007,6353
653,653,5267,2007-04-16 19:04:00,Sebastian Krause,0,2007,6353
654,654,5265,2007-04-16 19:04:00,Woodworthjohn,-104,2007,6249
655,659,5257,2007-04-16 19:05:00,Cnota,33,2007,6282
656,658,5258,2007-04-16 19:05:00,156.75.192.109,19,2007,6301
657,660,5256,2007-04-16 19:05:00,Editor Emeritus,44,2007,6345
658,656,5260,2007-04-16 19:05:00,Chrislk02,-7,2007,6338
659,655,5261,2007-04-16 19:05:00,220.245.204.116,7,2007,6345
660,657,5259,2007-04-16 19:05:00,Jmw0000,-64,2007,6281
661,668,5255,2007-04-16 19:06:00,Kizor,168,2007,6449
662,667,5253,2007-04-16 19:06:00,220.245.204.116,7,2007,6456
663,666,5252,2007-04-16 19:06:00,Jmw0000,-6,2007,6450
664,665,5254,2007-04-16 19:06:00,Cnota,72,2007,6522
665,669,5251,2007-04-16 19:06:00,Catalogingeek,195,2007,6717
666,663,5249,2007-04-16 19:06:00,206.218.129.2,-2,2007,6715
667,662,5248,2007-04-16 19:06:00,64.86.141.133,-14,2007,6701
668,661,5247,2007-04-16 19:06:00,Akubhai,-57,2007,6644
669,664,5250,2007-04-16 19:06:00,SillyWalksMinister,-13,2007,6631
670,670,5240,2007-04-16 19:07:00,Shanes,36,2007,6667
671,671,5239,2007-04-16 19:07:00,164.58.80.18,26,2007,6693
672,672,5242,2007-04-16 19:07:00,156.75.192.109,-39,2007,6654
673,673,5241,2007-04-16 19:07:00,156.75.192.109,3,2007,6657
674,674,5244,2007-04-16 19:07:00,John Stattic,108,2007,6765
675,675,5245,2007-04-16 19:07:00,72.66.28.80,-3,2007,6762
676,676,5246,2007-04-16 19:07:00,152.3.77.158,-124,2007,6638
677,677,5243,2007-04-16 19:07:00,Woodworthjohn,95,2007,6733
678,684,5235,2007-04-16 19:08:00,Kizor,1,2007,6734
679,686,5237,2007-04-16 19:08:00,Woodworthjohn,-2,2007,6732
680,685,5236,2007-04-16 19:08:00,Kizor,200,2007,6932
681,683,5234,2007-04-16 19:08:00,172.147.112.103,9,2007,6941
682,682,5233,2007-04-16 19:08:00,ElKevbo,-94,2007,6847
683,681,5232,2007-04-16 19:08:00,Jmw0000,-106,2007,6741
684,680,5231,2007-04-16 19:08:00,212.98.136.35,40,2007,6781
685,679,5230,2007-04-16 19:08:00,141.155.162.169,24,2007,6805
686,678,5238,2007-04-16 19:08:00,152.3.77.158,-157,2007,6648
687,696,5224,2007-04-16 19:09:00,TylerXKJ,-40,2007,6608
688,695,5228,2007-04-16 19:09:00,141.155.162.169,-40,2007,6568
689,694,5227,2007-04-16 19:09:00,Kizor,-26,2007,6542
690,692,5225,2007-04-16 19:09:00,Ishikawa Minoru,40,2007,6582
691,693,5226,2007-04-16 19:09:00,RyanGerbil10,0,2007,6582
692,690,5223,2007-04-16 19:09:00,PSUMark2006,-399,2007,6183
693,689,5222,2007-04-16 19:09:00,Woodworthjohn,97,2007,6280
694,688,5221,2007-04-16 19:09:00,Ishikawa Minoru,399,2007,6679
695,687,5220,2007-04-16 19:09:00,Chunky Rice,-5,2007,6674
696,691,5229,2007-04-16 19:09:00,220.245.204.116,2,2007,6676
697,697,5214,2007-04-16 19:10:00,Ike9898,13,2007,6689
698,698,5215,2007-04-16 19:10:00,Kizor,100,2007,6789
699,699,5218,2007-04-16 19:10:00,Feedmecereal,-1,2007,6788
700,700,5217,2007-04-16 19:10:00,Liore,45,2007,6833
701,701,5219,2007-04-16 19:10:00,Dposse,115,2007,6948
702,702,5216,2007-04-16 19:10:00,Wittylama,-1,2007,6947
703,706,5210,2007-04-16 19:11:00,UBeR,-6,2007,6941
704,705,5211,2007-04-16 19:11:00,Cjkline83,8,2007,6949
705,704,5212,2007-04-16 19:11:00,B,21,2007,6970
706,703,5213,2007-04-16 19:11:00,Liore,-45,2007,6925
707,707,5209,2007-04-16 19:12:00,Liore,123,2007,7048
708,708,5208,2007-04-16 19:12:00,Liore,-1,2007,7047
709,709,5207,2007-04-16 19:12:00,Kaldari,9,2007,7056
710,710,5203,2007-04-16 19:13:00,Btmachine333667,32,2007,7088
711,711,5205,2007-04-16 19:13:00,Jmw0000,0,2007,7088
712,712,5206,2007-04-16 19:13:00,Kizor,-23,2007,7065
713,713,5204,2007-04-16 19:13:00,Stevenscollege,-97,2007,6968
714,715,5201,2007-04-16 19:14:00,Smokefan2007,-95,2007,6873
715,716,5200,2007-04-16 19:14:00,Chunky Rice,0,2007,6873
716,714,5202,2007-04-16 19:14:00,Jmw0000,-2,2007,6871
717,717,5199,2007-04-16 19:15:00,Chunky Rice,-7,2007,6864
718,718,5198,2007-04-16 19:15:00,President David Palmer,136,2007,7000
719,719,5197,2007-04-16 19:15:00,Xyzzyplugh,4,2007,7004
720,720,5196,2007-04-16 19:15:00,Deletion Quality,45,2007,7049
721,721,5195,2007-04-16 19:15:00,President David Palmer,0,2007,7049
722,722,5193,2007-04-16 19:16:00,Eagle Owl,7,2007,7056
723,723,5194,2007-04-16 19:16:00,Rockpocket,-9,2007,7047
724,725,5192,2007-04-16 19:17:00,Ike9898,27,2007,7074
725,724,5190,2007-04-16 19:17:00,John Stattic,9,2007,7083
726,726,5191,2007-04-16 19:17:00,Jmw0000,44,2007,7127
727,728,5188,2007-04-16 19:18:00,Uthbrian,12,2007,7139
728,727,5189,2007-04-16 19:18:00,Chunky Rice,-27,2007,7112
729,731,5186,2007-04-16 19:19:00,Java13690,20,2007,7132
730,732,5185,2007-04-16 19:19:00,Dposse,-15,2007,7117
731,729,5184,2007-04-16 19:19:00,Warpflyght,3,2007,7120
732,730,5187,2007-04-16 19:19:00,Zenohockey,-4,2007,7116
733,735,5183,2007-04-16 19:20:00,Nyttend,0,2007,7116
734,733,5182,2007-04-16 19:20:00,Arpierson,0,2007,7116
735,734,5181,2007-04-16 19:20:00,Bokbok,8,2007,7124
736,736,5180,2007-04-16 19:21:00,Jarsonic,26,2007,7150
737,737,5179,2007-04-16 19:21:00,Sgt Pinback,19,2007,7169
738,738,5176,2007-04-16 19:22:00,Uthbrian,-4,2007,7165
739,739,5174,2007-04-16 19:22:00,Akubhai,24,2007,7189
740,740,5178,2007-04-16 19:22:00,Dposse,40,2007,7229
741,741,5177,2007-04-16 19:22:00,Zenohockey,67,2007,7296
742,742,5175,2007-04-16 19:22:00,DerwinUMD,8,2007,7304
743,748,5168,2007-04-16 19:23:00,Natalie Erin,-25,2007,7279
744,747,5169,2007-04-16 19:23:00,DerwinUMD,24,2007,7303
745,746,5170,2007-04-16 19:23:00,Kizor,86,2007,7389
746,744,5172,2007-04-16 19:23:00,Jmlk17,26,2007,7415
747,743,5173,2007-04-16 19:23:00,Jarsonic,-1,2007,7414
748,745,5171,2007-04-16 19:23:00,Natalie Erin,0,2007,7414
749,753,5165,2007-04-16 19:24:00,Zenohockey,-68,2007,7346
750,749,5163,2007-04-16 19:24:00,MZMcBride,0,2007,7346
751,750,5162,2007-04-16 19:24:00,Deletion Quality,-8,2007,7338
752,751,5164,2007-04-16 19:24:00,Adamantiaf,0,2007,7338
753,752,5166,2007-04-16 19:24:00,Kizor,-33,2007,7305
754,754,5167,2007-04-16 19:24:00,Jmw0000,23,2007,7328
755,755,5161,2007-04-16 19:25:00,Ishikawa Minoru,30,2007,7358
756,756,5160,2007-04-16 19:26:00,John Stattic,0,2007,7358
757,757,5159,2007-04-16 19:26:00,Akubhai,-54,2007,7304
758,758,5158,2007-04-16 19:26:00,TheCzarMan,-55,2007,7249
759,759,5157,2007-04-16 19:26:00,Dcandeto,1,2007,7250
760,760,5156,2007-04-16 19:26:00,Sgt Pinback,1,2007,7251
761,761,5155,2007-04-16 19:26:00,Natalie Erin,-4,2007,7247
762,768,5153,2007-04-16 19:27:00,Violask81976,1,2007,7248
763,767,5151,2007-04-16 19:27:00,Jarsonic,14,2007,7262
764,765,5152,2007-04-16 19:27:00,O^O,12,2007,7274
765,766,5154,2007-04-16 19:27:00,Bokbok,22,2007,7296
766,763,5149,2007-04-16 19:27:00,Alias777,-11,2007,7285
767,762,5148,2007-04-16 19:27:00,Cloudz679,-31,2007,7254
768,764,5150,2007-04-16 19:27:00,Kaldari,-475,2007,6779
769,769,5147,2007-04-16 19:28:00,Akubhai,0,2007,6779
770,770,5146,2007-04-16 19:28:00,Deletion Quality,-16,2007,6763
771,771,5145,2007-04-16 19:28:00,Ali'i,-5,2007,6758
772,775,5142,2007-04-16 19:29:00,Deletion Quality,-1,2007,6757
773,772,5141,2007-04-16 19:29:00,Jarsonic,0,2007,6757
774,773,5143,2007-04-16 19:29:00,Timothyarnold85,1,2007,6758
775,774,5144,2007-04-16 19:29:00,Dcandeto,1,2007,6759
776,777,5138,2007-04-16 19:30:00,Kizor,92,2007,6851
777,778,5140,2007-04-16 19:30:00,Jmw0000,0,2007,6851
778,776,5139,2007-04-16 19:30:00,Lg1223,-5,2007,6846
779,779,5137,2007-04-16 19:31:00,Donwilson,206,2007,7052
780,780,5136,2007-04-16 19:31:00,Jmw0000,0,2007,7052
781,781,5135,2007-04-16 19:31:00,John Stattic,11,2007,7063
782,782,5134,2007-04-16 19:32:00,Kizor,-55,2007,7008
783,783,5133,2007-04-16 19:32:00,Donwilson,20,2007,7028
784,784,5132,2007-04-16 19:32:00,O^O,98,2007,7126
785,786,5130,2007-04-16 19:33:00,Jmw0000,38,2007,7164
786,785,5128,2007-04-16 19:33:00,Natalie Erin,0,2007,7164
787,787,5129,2007-04-16 19:33:00,Kizor,-54,2007,7110
788,788,5131,2007-04-16 19:33:00,Stbalbach,-48,2007,7062
789,793,5123,2007-04-16 19:34:00,John Stattic,-7,2007,7055
790,792,5124,2007-04-16 19:34:00,Dcandeto,48,2007,7103
791,789,5127,2007-04-16 19:34:00,Dharmabatteries,-16,2007,7087
792,790,5126,2007-04-16 19:34:00,Alangu,-1,2007,7086
793,794,5122,2007-04-16 19:34:00,Jmw0000,-412,2007,6674
794,791,5125,2007-04-16 19:34:00,MZMcBride,89,2007,6763
795,798,5119,2007-04-16 19:35:00,Msikma,-2,2007,6761
796,797,5121,2007-04-16 19:35:00,Tomasboij,1,2007,6762
797,795,5118,2007-04-16 19:35:00,Astanhope,18,2007,6780
798,796,5120,2007-04-16 19:35:00,CieloEstrellado,52,2007,6832
799,802,5114,2007-04-16 19:36:00,DerwinUMD,-25,2007,6807
800,801,5115,2007-04-16 19:36:00,Tbone762,10,2007,6817
801,799,5117,2007-04-16 19:36:00,Flavourdan,-111,2007,6706
802,800,5116,2007-04-16 19:36:00,Yksin,62,2007,6768
803,803,5108,2007-04-16 19:37:00,AEMoreira042281,0,2007,6768
804,804,5110,2007-04-16 19:37:00,Wise,0,2007,6768
805,805,5109,2007-04-16 19:37:00,CieloEstrellado,9,2007,6777
806,806,5112,2007-04-16 19:37:00,Kizor,10,2007,6787
807,807,5113,2007-04-16 19:37:00,Natalie Erin,-98,2007,6689
808,808,5111,2007-04-16 19:37:00,Jmw0000,0,2007,6689
809,809,5107,2007-04-16 19:38:00,Greensprout,137,2007,6826
810,810,5106,2007-04-16 19:38:00,Melicans,170,2007,6996
811,811,5105,2007-04-16 19:38:00,ElKevbo,-1,2007,6995
812,812,5104,2007-04-16 19:38:00,Kizor,-49,2007,6946
813,816,5100,2007-04-16 19:39:00,Thomas Matthews,-4,2007,6942
814,813,5103,2007-04-16 19:39:00,Astanhope,-15,2007,6927
815,814,5102,2007-04-16 19:39:00,Kizor,0,2007,6927
816,815,5101,2007-04-16 19:39:00,Jmw0000,0,2007,6927
817,819,5099,2007-04-16 19:40:00,Thomas Matthews,-2,2007,6925
818,820,5098,2007-04-16 19:40:00,Jmw0000,-6,2007,6919
819,817,5096,2007-04-16 19:40:00,Stanley011,0,2007,6919
820,818,5097,2007-04-16 19:40:00,Tomasboij,-137,2007,6782
821,824,5092,2007-04-16 19:41:00,Dcandeto,8,2007,6790
822,823,5093,2007-04-16 19:41:00,Karrmann,147,2007,6937
823,822,5094,2007-04-16 19:41:00,Youngamerican,0,2007,6937
824,821,5095,2007-04-16 19:41:00,John Stattic,13,2007,6950
825,832,5091,2007-04-16 19:42:00,Astanhope,0,2007,6950
826,831,5090,2007-04-16 19:42:00,Kizor,175,2007,7125
827,830,5089,2007-04-16 19:42:00,John Stattic,0,2007,7125
828,829,5088,2007-04-16 19:42:00,Kaldari,0,2007,7125
829,833,5087,2007-04-16 19:42:00,Jmw0000,0,2007,7125
830,827,5085,2007-04-16 19:42:00,Halo,47,2007,7172
831,826,5084,2007-04-16 19:42:00,AEMoreira042281,-43,2007,7129
832,825,5083,2007-04-16 19:42:00,Deletion Quality,125,2007,7254
833,828,5086,2007-04-16 19:42:00,Kizor,1,2007,7255
834,834,5077,2007-04-16 19:43:00,CieloEstrellado,-52,2007,7203
835,835,5076,2007-04-16 19:43:00,Timothyarnold85,32,2007,7235
836,836,5078,2007-04-16 19:43:00,Jmw0000,-2,2007,7233
837,837,5075,2007-04-16 19:43:00,John Stattic,2,2007,7235
838,838,5080,2007-04-16 19:43:00,Karrmann,20,2007,7255
839,839,5081,2007-04-16 19:43:00,CieloEstrellado,56,2007,7311
840,840,5082,2007-04-16 19:43:00,Jmw0000,0,2007,7311
841,841,5079,2007-04-16 19:43:00,Threeafterthree,-7,2007,7304
842,847,5069,2007-04-16 19:44:00,AEMoreira042281,1,2007,7305
843,846,5070,2007-04-16 19:44:00,Kizor,-32,2007,7273
844,845,5071,2007-04-16 19:44:00,AEMoreira042281,-58,2007,7215
845,843,5073,2007-04-16 19:44:00,Dposse,170,2007,7385
846,842,5074,2007-04-16 19:44:00,Stanley011,38,2007,7423
847,844,5072,2007-04-16 19:44:00,Kizor,87,2007,7510
848,853,5066,2007-04-16 19:45:00,Ens,87,2007,7597
849,848,5063,2007-04-16 19:45:00,Bokbok,23,2007,7620
850,849,5064,2007-04-16 19:45:00,Coemgenus,-169,2007,7451
851,850,5065,2007-04-16 19:45:00,Halo,47,2007,7498
852,851,5067,2007-04-16 19:45:00,Dcandeto,-36,2007,7462
853,852,5068,2007-04-16 19:45:00,Zanimum,68,2007,7530
854,859,5057,2007-04-16 19:46:00,Kaldari,0,2007,7530
855,858,5058,2007-04-16 19:46:00,Smokefan2007,292,2007,7822
856,857,5059,2007-04-16 19:46:00,Dcandeto,2,2007,7824
857,856,5060,2007-04-16 19:46:00,AEMoreira042281,133,2007,7957
858,854,5062,2007-04-16 19:46:00,Wittylama,-67,2007,7890
859,855,5061,2007-04-16 19:46:00,Dposse,-24,2007,7866
860,864,5055,2007-04-16 19:47:00,Dcandeto,0,2007,7866
861,863,5054,2007-04-16 19:47:00,Pmac2322,0,2007,7866
862,865,5053,2007-04-16 19:47:00,Ali'i,0,2007,7866
863,861,5052,2007-04-16 19:47:00,Moncrief,8,2007,7874
864,860,5051,2007-04-16 19:47:00,AEMoreira042281,-18,2007,7856
865,862,5050,2007-04-16 19:47:00,Jmw0000,0,2007,7856
866,869,5046,2007-04-16 19:48:00,Kizor,28,2007,7884
867,868,5047,2007-04-16 19:48:00,Burntsauce,0,2007,7884
868,867,5048,2007-04-16 19:48:00,Flavourdan,-105,2007,7779
869,866,5049,2007-04-16 19:48:00,Moncrief,5,2007,7784
870,870,5041,2007-04-16 19:49:00,Swatjester,201,2007,7985
871,871,5042,2007-04-16 19:49:00,Bokbok,22,2007,8007
872,872,5040,2007-04-16 19:49:00,Yksin,355,2007,8362
873,873,5044,2007-04-16 19:49:00,Kizor,1,2007,8363
874,874,5045,2007-04-16 19:49:00,Kaustuv,4,2007,8367
875,875,5043,2007-04-16 19:49:00,O^O,-8,2007,8359
876,877,5038,2007-04-16 19:50:00,Alangu,-1,2007,8358
877,876,5039,2007-04-16 19:50:00,Bando26,1,2007,8359
878,878,5037,2007-04-16 19:50:00,Donwilson,-1,2007,8358
879,879,5036,2007-04-16 19:50:00,Mithent,-3,2007,8355
880,880,5035,2007-04-16 19:50:00,Jarsonic,1,2007,8356
881,881,5034,2007-04-16 19:50:00,Alangu,-2,2007,8354
882,882,5033,2007-04-16 19:50:00,Alias777,-1,2007,8353
883,889,5032,2007-04-16 19:51:00,RogerWNZ,-9,2007,8344
884,888,5031,2007-04-16 19:51:00,Jarsonic,0,2007,8344
885,890,5029,2007-04-16 19:51:00,Matt Yohe,132,2007,8476
886,887,5030,2007-04-16 19:51:00,UltraNurd,0,2007,8476
887,885,5028,2007-04-16 19:51:00,Dcandeto,0,2007,8476
888,884,5026,2007-04-16 19:51:00,Swatjester,288,2007,8764
889,883,5025,2007-04-16 19:51:00,Jarsonic,2,2007,8766
890,886,5027,2007-04-16 19:51:00,Greensprout,142,2007,8908
891,891,5024,2007-04-16 19:52:00,Dposse,-134,2007,8774
892,892,5023,2007-04-16 19:52:00,Zone46,1,2007,8775
893,893,5022,2007-04-16 19:52:00,Emolotricity,38,2007,8813
894,894,5021,2007-04-16 19:52:00,Wittylama,132,2007,8945
895,895,5020,2007-04-16 19:52:00,Matt Yohe,90,2007,9035
896,896,5019,2007-04-16 19:52:00,O^O,60,2007,9095
897,897,5018,2007-04-16 19:52:00,Dcandeto,-142,2007,8953
898,898,5017,2007-04-16 19:52:00,Jmw0000,0,2007,8953
899,899,5016,2007-04-16 19:52:00,Alangu,-13,2007,8940
900,905,5013,2007-04-16 19:53:00,Dcandeto,0,2007,8940
901,906,5014,2007-04-16 19:53:00,Dposse,58,2007,8998
902,904,5012,2007-04-16 19:53:00,Pmac2322,73,2007,9071
903,907,5011,2007-04-16 19:53:00,ObtuseAngle,1,2007,9072
904,902,5010,2007-04-16 19:53:00,O^O,-19,2007,9053
905,901,5009,2007-04-16 19:53:00,Alangu,4,2007,9057
906,900,5008,2007-04-16 19:53:00,Jarsonic,1,2007,9058
907,903,5015,2007-04-16 19:53:00,Alangu,0,2007,9058
908,915,5007,2007-04-16 19:54:00,Tomasboij,-1,2007,9057
909,914,5004,2007-04-16 19:54:00,Matt Yohe,-199,2007,8858
910,917,5005,2007-04-16 19:54:00,Alfiboy,0,2007,8858
911,916,5003,2007-04-16 19:54:00,Dposse,3,2007,8861
912,913,5002,2007-04-16 19:54:00,Twas Now,10,2007,8871
913,918,5006,2007-04-16 19:54:00,Jarsonic,2,2007,8873
914,911,5000,2007-04-16 19:54:00,VT hawkeye,-40,2007,8833
915,910,4999,2007-04-16 19:54:00,Kizor,-55,2007,8778
916,909,4998,2007-04-16 19:54:00,Wittylama,136,2007,8914
917,908,4997,2007-04-16 19:54:00,Dposse,-5,2007,8909
918,912,5001,2007-04-16 19:54:00,Threeafterthree,-7,2007,8902
919,919,4996,2007-04-16 19:55:00,Wittylama,-1,2007,8901
920,920,4995,2007-04-16 19:55:00,Twas Now,0,2007,8901
921,921,4994,2007-04-16 19:55:00,VT hawkeye,0,2007,8901
922,922,4993,2007-04-16 19:55:00,Dposse,-267,2007,8634
923,923,4992,2007-04-16 19:55:00,Dcandeto,67,2007,8701
924,924,4991,2007-04-16 19:55:00,Greensprout,144,2007,8845
925,931,4987,2007-04-16 19:56:00,Rockpocket,-141,2007,8704
926,930,4990,2007-04-16 19:56:00,John Stattic,211,2007,8915
927,929,4989,2007-04-16 19:56:00,Alangu,-1,2007,8914
928,925,4984,2007-04-16 19:56:00,Alfiboy,1,2007,8915
929,927,4986,2007-04-16 19:56:00,Dcandeto,95,2007,9010
930,926,4985,2007-04-16 19:56:00,Matt Yohe,4,2007,9014
931,928,4988,2007-04-16 19:56:00,Alison,83,2007,9097
932,939,4981,2007-04-16 19:57:00,O^O,135,2007,9232
933,942,4978,2007-04-16 19:57:00,Moncrief,-13,2007,9219
934,941,4983,2007-04-16 19:57:00,Cmichael,19,2007,9238
935,940,4982,2007-04-16 19:57:00,Kizor,99,2007,9337
936,938,4980,2007-04-16 19:57:00,Matt Yohe,-199,2007,9138
937,936,4973,2007-04-16 19:57:00,Swatjester,244,2007,9382
938,935,4977,2007-04-16 19:57:00,Threeafterthree,-7,2007,9375
939,934,4975,2007-04-16 19:57:00,Alangu,-112,2007,9263
940,933,4974,2007-04-16 19:57:00,Dposse,-132,2007,9131
941,932,4976,2007-04-16 19:57:00,Zone46,1,2007,9132
942,937,4979,2007-04-16 19:57:00,Arichnad,33,2007,9165
943,948,4970,2007-04-16 19:58:00,Jmw0000,-124,2007,9041
944,951,4968,2007-04-16 19:58:00,B,0,2007,9041
945,950,4972,2007-04-16 19:58:00,Dposse,18,2007,9059
946,949,4971,2007-04-16 19:58:00,Donwilson,38,2007,9097
947,947,4969,2007-04-16 19:58:00,Joel22,4,2007,9101
948,946,4967,2007-04-16 19:58:00,Alangu,0,2007,9101
949,945,4966,2007-04-16 19:58:00,Dposse,-73,2007,9028
950,944,4965,2007-04-16 19:58:00,B,-16,2007,9012
951,943,4964,2007-04-16 19:58:00,Arichnad,5,2007,9017
952,952,4959,2007-04-16 19:59:00,Kizor,28,2007,9045
953,953,4960,2007-04-16 19:59:00,Jmw0000,-38,2007,9007
954,954,4963,2007-04-16 19:59:00,Donwilson,-2,2007,9005
955,955,4962,2007-04-16 19:59:00,Akubhai,0,2007,9005
956,956,4961,2007-04-16 19:59:00,Sgt Pinback,19,2007,9024
957,961,4954,2007-04-16 20:00:00,Xuxunette,13,2007,9037
958,960,4955,2007-04-16 20:00:00,72.13.141.49,3,2007,9040
959,962,4953,2007-04-16 20:00:00,Rockpocket,-10,2007,9030
960,958,4957,2007-04-16 20:00:00,Chmod007,14,2007,9044
961,957,4958,2007-04-16 20:00:00,Kizor,5,2007,9049
962,959,4956,2007-04-16 20:00:00,Rockpocket,-37,2007,9012
963,963,4946,2007-04-16 20:01:00,Tomasboij,7,2007,9019
964,964,4947,2007-04-16 20:01:00,AEMoreira042281,0,2007,9019
965,965,4948,2007-04-16 20:01:00,Alangu,96,2007,9115
966,966,4951,2007-04-16 20:01:00,Evanreyes,0,2007,9115
967,967,4950,2007-04-16 20:01:00,Raden,81,2007,9196
968,968,4952,2007-04-16 20:01:00,Jmw0000,49,2007,9245
969,969,4949,2007-04-16 20:01:00,Threeafterthree,-1,2007,9244
970,977,4938,2007-04-16 20:02:00,Rockpocket,-81,2007,9163
971,976,4939,2007-04-16 20:02:00,72.13.141.49,146,2007,9309
972,975,4940,2007-04-16 20:02:00,Dposse,76,2007,9385
973,974,4941,2007-04-16 20:02:00,Evanreyes,4,2007,9389
974,971,4944,2007-04-16 20:02:00,70.179.123.36,0,2007,9389
975,972,4943,2007-04-16 20:02:00,Evanreyes,0,2007,9389
976,970,4945,2007-04-16 20:02:00,Alangu,21,2007,9410
977,973,4942,2007-04-16 20:02:00,Gymboy689,75,2007,9485
978,984,4933,2007-04-16 20:03:00,128.172.29.36,1,2007,9486
979,987,4937,2007-04-16 20:03:00,Wl219,-21,2007,9465
980,986,4935,2007-04-16 20:03:00,Swatjester,0,2007,9465
981,988,4932,2007-04-16 20:03:00,Wl219,0,2007,9465
982,983,4936,2007-04-16 20:03:00,128.172.29.36,-45,2007,9420
983,985,4934,2007-04-16 20:03:00,Dposse,76,2007,9496
984,981,4930,2007-04-16 20:03:00,Dcandeto,-99,2007,9397
985,980,4929,2007-04-16 20:03:00,Donwilson,-8,2007,9389
986,979,4928,2007-04-16 20:03:00,Dcandeto,67,2007,9456
987,978,4927,2007-04-16 20:03:00,LaKaMa113,0,2007,9456
988,982,4931,2007-04-16 20:03:00,Donwilson,0,2007,9456
989,989,4922,2007-04-16 20:04:00,Jmw0000,6,2007,9462
990,990,4923,2007-04-16 20:04:00,Timothyarnold85,-2,2007,9460
991,991,4926,2007-04-16 20:04:00,69.183.42.173,-1,2007,9459
992,992,4925,2007-04-16 20:04:00,Gdo01,1,2007,9460
993,993,4924,2007-04-16 20:04:00,Kizor,13,2007,9473
994,1000,4915,2007-04-16 20:05:00,Natalie Erin,0,2007,9473
995,999,4916,2007-04-16 20:05:00,131.91.83.93,-20,2007,9453
996,998,4917,2007-04-16 20:05:00,Natalie Erin,-4,2007,9449
997,997,4918,2007-04-16 20:05:00,Timothyarnold85,4,2007,9453
998,995,4920,2007-04-16 20:05:00,Swatjester,117,2007,9570
999,994,4921,2007-04-16 20:05:00,Dposse,-96,2007,9474
1000,996,4919,2007-04-16 20:05:00,Kizor,50,2007,9524
1001,1001,4909,2007-04-16 20:06:00,Swatjester,0,2007,9524
1002,1002,4910,2007-04-16 20:06:00,160.129.129.163,0,2007,9524
1003,1003,4914,2007-04-16 20:06:00,70.119.182.244,-2,2007,9522
1004,1004,4912,2007-04-16 20:06:00,Tomasboij,4,2007,9526
1005,1005,4913,2007-04-16 20:06:00,Xyzzyplugh,5,2007,9531
1006,1006,4911,2007-04-16 20:06:00,Xyzzyplugh,1,2007,9532
1007,1012,4908,2007-04-16 20:07:00,Dcandeto,4,2007,9536
1008,1014,4907,2007-04-16 20:07:00,Walkiped,12,2007,9548
1009,1013,4905,2007-04-16 20:07:00,Natalie Erin,0,2007,9548
1010,1011,4906,2007-04-16 20:07:00,Penguinee,42,2007,9590
1011,1007,4901,2007-04-16 20:07:00,Reilly2950,0,2007,9590
1012,1009,4904,2007-04-16 20:07:00,AEMoreira042281,37,2007,9627
1013,1008,4902,2007-04-16 20:07:00,AEMoreira042281,-4,2007,9623
1014,1010,4903,2007-04-16 20:07:00,Tomasboij,-15,2007,9608
1015,1015,4894,2007-04-16 20:08:00,Kizor,84,2007,9692
1016,1016,4895,2007-04-16 20:08:00,Donwilson,202,2007,9894
1017,1017,4896,2007-04-16 20:08:00,O^O,-7,2007,9887
1018,1018,4900,2007-04-16 20:08:00,Dposse,10,2007,9897
1019,1019,4898,2007-04-16 20:08:00,Kizor,-84,2007,9813
1020,1020,4899,2007-04-16 20:08:00,Dcandeto,-158,2007,9655
1021,1021,4897,2007-04-16 20:08:00,Dcandeto,67,2007,9722
1022,1026,4891,2007-04-16 20:09:00,Natalie Erin,-5,2007,9717
1023,1025,4893,2007-04-16 20:09:00,Donwilson,0,2007,9717
1024,1022,4890,2007-04-16 20:09:00,AEMoreira042281,68,2007,9785
1025,1023,4889,2007-04-16 20:09:00,Natalie Erin,-1,2007,9784
1026,1024,4892,2007-04-16 20:09:00,Sccrcrzy13,21,2007,9805
1027,1027,4888,2007-04-16 20:10:00,Sixteen Left,5,2007,9810
1028,1028,4887,2007-04-16 20:10:00,Dposse,-9,2007,9801
1029,1029,4885,2007-04-16 20:10:00,Corvokarasu,33,2007,9834
1030,1030,4886,2007-04-16 20:10:00,Jmw0000,11,2007,9845
1031,1034,4881,2007-04-16 20:11:00,Kizor,-54,2007,9791
1032,1033,4882,2007-04-16 20:11:00,Jmw0000,30,2007,9821
1033,1035,4880,2007-04-16 20:11:00,Xyzzyplugh,16,2007,9837
1034,1031,4884,2007-04-16 20:11:00,Kizor,51,2007,9888
1035,1032,4883,2007-04-16 20:11:00,Ektar,-36,2007,9852
1036,1036,4875,2007-04-16 20:12:00,Swatjester,0,2007,9852
1037,1037,4874,2007-04-16 20:12:00,Dcandeto,-41,2007,9811
1038,1038,4877,2007-04-16 20:12:00,Jmw0000,67,2007,9878
1039,1039,4879,2007-04-16 20:12:00,Zehly,28,2007,9906
1040,1040,4876,2007-04-16 20:12:00,Swatjester,-4,2007,9902
1041,1041,4873,2007-04-16 20:13:00,Cinemaniac86,1,2007,9903
1042,1042,4872,2007-04-16 20:13:00,Kizor,187,2007,10090
1043,1043,4871,2007-04-16 20:13:00,CLWE,0,2007,10090
1044,1044,4870,2007-04-16 20:13:00,Threeafterthree,-22,2007,10068
1045,1045,4869,2007-04-16 20:13:00,Swatjester,0,2007,10068
1046,1054,4864,2007-04-16 20:14:00,Xyzzyplugh,-1,2007,10067
1047,1053,4868,2007-04-16 20:14:00,Kizor,-54,2007,10013
1048,1052,4867,2007-04-16 20:14:00,Penguinee,104,2007,10117
1049,1051,4866,2007-04-16 20:14:00,Jessikins,-55,2007,10062
1050,1046,4860,2007-04-16 20:14:00,Dcandeto,25,2007,10087
1051,1049,4863,2007-04-16 20:14:00,Dcandeto,0,2007,10087
1052,1048,4862,2007-04-16 20:14:00,President David Palmer,140,2007,10227
1053,1047,4861,2007-04-16 20:14:00,Lothar76,-1,2007,10226
1054,1050,4865,2007-04-16 20:14:00,SuperJ9587,43,2007,10269
1055,1062,4857,2007-04-16 20:15:00,Swatjester,0,2007,10269
1056,1064,4859,2007-04-16 20:15:00,FunPika,-14,2007,10255
1057,1065,4854,2007-04-16 20:15:00,Cinemaniac86,-1,2007,10254
1058,1063,4858,2007-04-16 20:15:00,Mac Davis,0,2007,10254
1059,1061,4856,2007-04-16 20:15:00,Penguinee,-44,2007,10210
1060,1056,4850,2007-04-16 20:15:00,Cinemaniac86,7,2007,10217
1061,1059,4853,2007-04-16 20:15:00,FunPika,8,2007,10225
1062,1055,4849,2007-04-16 20:15:00,Penguinee,-92,2007,10133
1063,1060,4855,2007-04-16 20:15:00,Emolotricity,25,2007,10158
1064,1058,4852,2007-04-16 20:15:00,Dcandeto,0,2007,10158
1065,1057,4851,2007-04-16 20:15:00,Dposse,21,2007,10179
1066,1066,4848,2007-04-16 20:16:00,Gdo01,-46,2007,10133
1067,1067,4847,2007-04-16 20:16:00,Kizor,-31,2007,10102
1068,1068,4846,2007-04-16 20:16:00,Karrmann,28,2007,10130
1069,1069,4845,2007-04-16 20:16:00,Kizor,-55,2007,10075
1070,1077,4840,2007-04-16 20:17:00,Dposse,21,2007,10096
1071,1076,4844,2007-04-16 20:17:00,Dcandeto,77,2007,10173
1072,1075,4842,2007-04-16 20:17:00,Kizor,-35,2007,10138
1073,1074,4841,2007-04-16 20:17:00,Penguinee,-43,2007,10095
1074,1072,4839,2007-04-16 20:17:00,Qrc2006,25,2007,10120
1075,1071,4838,2007-04-16 20:17:00,Yksin,48,2007,10168
1076,1073,4843,2007-04-16 20:17:00,Ektar,-44,2007,10124
1077,1070,4837,2007-04-16 20:17:00,Kizor,1,2007,10125
1078,1082,4835,2007-04-16 20:18:00,Dcandeto,95,2007,10220
1079,1084,4833,2007-04-16 20:18:00,Cinemaniac86,24,2007,10244
1080,1083,4836,2007-04-16 20:18:00,Qrc2006,0,2007,10244
1081,1081,4834,2007-04-16 20:18:00,Cerebrus13,36,2007,10280
1082,1079,4832,2007-04-16 20:18:00,Elliskev,113,2007,10393
1083,1078,4830,2007-04-16 20:18:00,Tomasboij,-17,2007,10376
1084,1080,4831,2007-04-16 20:18:00,Jmlk17,11,2007,10387
1085,1085,4829,2007-04-16 20:19:00,Threeafterthree,-22,2007,10365
1086,1086,4828,2007-04-16 20:19:00,Tomasboij,-1,2007,10364
1087,1087,4827,2007-04-16 20:19:00,Penguinee,-46,2007,10318
1088,1088,4826,2007-04-16 20:19:00,John Reaves,7,2007,10325
1089,1089,4825,2007-04-16 20:19:00,Karrmann,64,2007,10389
1090,1094,4822,2007-04-16 20:20:00,Kizor,-34,2007,10355
1091,1093,4824,2007-04-16 20:20:00,Dcandeto,-37,2007,10318
1092,1091,4821,2007-04-16 20:20:00,Kizor,0,2007,10318
1093,1090,4820,2007-04-16 20:20:00,Zone46,-1,2007,10317
1094,1092,4823,2007-04-16 20:20:00,Karrmann,0,2007,10317
1095,1095,4819,2007-04-16 20:21:00,Uthbrian,3,2007,10320
1096,1096,4818,2007-04-16 20:21:00,John Stattic,0,2007,10320
1097,1097,4817,2007-04-16 20:21:00,Akubhai,-25,2007,10295
1098,1098,4816,2007-04-16 20:21:00,Tomasboij,12,2007,10307
1099,1099,4815,2007-04-16 20:21:00,Akubhai,-1,2007,10306
1100,1103,4811,2007-04-16 20:22:00,John Reaves,-7,2007,10299
1101,1101,4813,2007-04-16 20:22:00,CLWE,0,2007,10299
1102,1100,4814,2007-04-16 20:22:00,Penguinee,-2,2007,10297
1103,1102,4812,2007-04-16 20:22:00,Threeafterthree,19,2007,10316
1104,1104,4808,2007-04-16 20:23:00,Threeafterthree,9,2007,10325
1105,1105,4809,2007-04-16 20:23:00,Penguinee,-8,2007,10317
1106,1106,4810,2007-04-16 20:23:00,Moncrief,12,2007,10329
1107,1107,4807,2007-04-16 20:24:00,Katalaveno,147,2007,10476
1108,1108,4806,2007-04-16 20:24:00,Crissida,-3,2007,10473
1109,1109,4805,2007-04-16 20:24:00,Karrmann,241,2007,10714
1110,1110,4804,2007-04-16 20:24:00,Gdo01,-4,2007,10710
1111,1111,4803,2007-04-16 20:24:00,Timothyarnold85,0,2007,10710
1112,1112,4802,2007-04-16 20:24:00,Gdo01,-19,2007,10691
1113,1116,4798,2007-04-16 20:25:00,Harthacnut,35,2007,10726
1114,1115,4799,2007-04-16 20:25:00,Timothyarnold85,1,2007,10727
1115,1113,4801,2007-04-16 20:25:00,TheOtherSiguy,-7,2007,10720
1116,1114,4800,2007-04-16 20:25:00,Abe.Froman,-241,2007,10479
1117,1117,4792,2007-04-16 20:26:00,Swatjester,-1,2007,10478
1118,1118,4793,2007-04-16 20:26:00,Kizor,94,2007,10572
1119,1119,4796,2007-04-16 20:26:00,Danlock2,-1,2007,10571
1120,1120,4795,2007-04-16 20:26:00,John Stattic,-1,2007,10570
1121,1121,4797,2007-04-16 20:26:00,AEMoreira042281,70,2007,10640
1122,1122,4794,2007-04-16 20:26:00,Penguinee,1,2007,10641
1123,1127,4787,2007-04-16 20:27:00,Dcandeto,-4,2007,10637
1124,1126,4788,2007-04-16 20:27:00,Kizor,0,2007,10637
1125,1123,4791,2007-04-16 20:27:00,Kizor,-62,2007,10575
1126,1124,4790,2007-04-16 20:27:00,Irish Pearl,51,2007,10626
1127,1125,4789,2007-04-16 20:27:00,Timothyarnold85,1,2007,10627
1128,1128,4782,2007-04-16 20:28:00,Yaf,-22,2007,10605
1129,1129,4783,2007-04-16 20:28:00,Kizor,-53,2007,10552
1130,1130,4785,2007-04-16 20:28:00,CLWE,55,2007,10607
1131,1131,4786,2007-04-16 20:28:00,Natalie Erin,-2,2007,10605
1132,1132,4784,2007-04-16 20:28:00,Jmlk17,26,2007,10631
1133,1140,4774,2007-04-16 20:29:00,AEMoreira042281,1,2007,10632
1134,1139,4775,2007-04-16 20:29:00,Alangu,35,2007,10667
1135,1138,4776,2007-04-16 20:29:00,Jmlk17,-6,2007,10661
1136,1137,4777,2007-04-16 20:29:00,Moncrief,-1,2007,10660
1137,1134,4780,2007-04-16 20:29:00,Moncrief,0,2007,10660
1138,1135,4779,2007-04-16 20:29:00,Penguinee,0,2007,10660
1139,1133,4781,2007-04-16 20:29:00,Kizor,-15,2007,10645
1140,1136,4778,2007-04-16 20:29:00,Rdfox 76,-15,2007,10630
1141,1146,4770,2007-04-16 20:30:00,Cymbalta,0,2007,10630
1142,1148,4769,2007-04-16 20:30:00,Kizor,-2,2007,10628
1143,1145,4773,2007-04-16 20:30:00,Polarscribe,1,2007,10629
1144,1147,4772,2007-04-16 20:30:00,President David Palmer,-2,2007,10627
1145,1143,4767,2007-04-16 20:30:00,Netscott,9,2007,10636
1146,1142,4766,2007-04-16 20:30:00,Kizor,14,2007,10650
1147,1141,4771,2007-04-16 20:30:00,Sccrcrzy13,112,2007,10762
1148,1144,4768,2007-04-16 20:30:00,John Reaves,0,2007,10762
1149,1149,4765,2007-04-16 20:31:00,Kizor,1,2007,10763
1150,1150,4764,2007-04-16 20:31:00,Gdo01,-51,2007,10712
1151,1159,4763,2007-04-16 20:32:00,Yksin,148,2007,10860
1152,1158,4762,2007-04-16 20:32:00,Tomasboij,1,2007,10861
1153,1157,4761,2007-04-16 20:32:00,Cymbalta,42,2007,10903
1154,1156,4760,2007-04-16 20:32:00,Dcandeto,0,2007,10903
1155,1155,4759,2007-04-16 20:32:00,Kaldari,-18,2007,10885
1156,1153,4755,2007-04-16 20:32:00,Gtg204y,-19,2007,10866
1157,1152,4757,2007-04-16 20:32:00,Dcandeto,7,2007,10873
1158,1151,4756,2007-04-16 20:32:00,Ektar,-464,2007,10409
1159,1154,4758,2007-04-16 20:32:00,Teh Suck,-6,2007,10403
1160,1160,4754,2007-04-16 20:33:00,Kizor,-19,2007,10384
1161,1161,4753,2007-04-16 20:33:00,Zshortman,58,2007,10442
1162,1162,4752,2007-04-16 20:33:00,Yksin,-432,2007,10010
1163,1163,4751,2007-04-16 20:33:00,Dcandeto,0,2007,10010
1164,1164,4750,2007-04-16 20:33:00,Kizor,1,2007,10011
1165,1169,4747,2007-04-16 20:34:00,Uthbrian,4,2007,10015
1166,1167,4748,2007-04-16 20:34:00,Xyzzyplugh,0,2007,10015
1167,1168,4749,2007-04-16 20:34:00,Penguinee,39,2007,10054
1168,1165,4746,2007-04-16 20:34:00,Bluefield,116,2007,10170
1169,1166,4745,2007-04-16 20:34:00,Deletion Quality,8,2007,10178
1170,1170,4744,2007-04-16 20:35:00,Skarioffszky,-3,2007,10175
1171,1171,4743,2007-04-16 20:35:00,Dycedarg,4,2007,10179
1172,1172,4742,2007-04-16 20:35:00,Kizor,-19,2007,10160
1173,1173,4741,2007-04-16 20:35:00,Teh Suck,52,2007,10212
1174,1174,4740,2007-04-16 20:36:00,Uthbrian,25,2007,10237
1175,1175,4739,2007-04-16 20:36:00,Elliskev,-2,2007,10235
1176,1176,4738,2007-04-16 20:36:00,Liore,329,2007,10564
1177,1177,4737,2007-04-16 20:36:00,AEMoreira042281,19,2007,10583
1178,1184,4733,2007-04-16 20:37:00,Spectheintro,-25,2007,10558
1179,1183,4735,2007-04-16 20:37:00,AEMoreira042281,-3,2007,10555
1180,1182,4736,2007-04-16 20:37:00,Ektar,45,2007,10600
1181,1180,4732,2007-04-16 20:37:00,Liore,42,2007,10642
1182,1179,4730,2007-04-16 20:37:00,Uthbrian,4,2007,10646
1183,1178,4731,2007-04-16 20:37:00,John Stattic,-245,2007,10401
1184,1181,4734,2007-04-16 20:37:00,Kizor,-69,2007,10332
1185,1185,4729,2007-04-16 20:38:00,Alkivar,1,2007,10333
1186,1186,4728,2007-04-16 20:38:00,AEMoreira042281,-96,2007,10237
1187,1187,4727,2007-04-16 20:38:00,Fvasconcellos,-5,2007,10232
1188,1188,4726,2007-04-16 20:38:00,Katalaveno,242,2007,10474
1189,1189,4725,2007-04-16 20:38:00,Natalie Erin,0,2007,10474
1190,1194,4724,2007-04-16 20:39:00,Kizor,-19,2007,10455
1191,1195,4722,2007-04-16 20:39:00,Deletion Quality,8,2007,10463
1192,1192,4721,2007-04-16 20:39:00,Skarioffszky,22,2007,10485
1193,1191,4720,2007-04-16 20:39:00,Getinthek,283,2007,10768
1194,1193,4723,2007-04-16 20:39:00,Kizor,-241,2007,10527
1195,1190,4719,2007-04-16 20:39:00,Alkivar,-7,2007,10520
1196,1196,4718,2007-04-16 20:40:00,Penguinee,-46,2007,10474
1197,1197,4717,2007-04-16 20:40:00,Totherack1021j,0,2007,10474
1198,1198,4716,2007-04-16 20:40:00,Konstantin~enwiki,4,2007,10478
1199,1199,4715,2007-04-16 20:40:00,Titoxd,-343,2007,10135
1200,1200,4714,2007-04-16 20:40:00,Getinthek,76,2007,10211
1201,1206,4712,2007-04-16 20:41:00,Ektar,51,2007,10262
1202,1205,4710,2007-04-16 20:41:00,Kizor,23,2007,10285
1203,1204,4711,2007-04-16 20:41:00,Natalie Erin,0,2007,10285
1204,1202,4709,2007-04-16 20:41:00,Elliskev,152,2007,10437
1205,1201,4708,2007-04-16 20:41:00,Penguinee,1,2007,10438
1206,1203,4713,2007-04-16 20:41:00,Gdo01,-15,2007,10423
1207,1207,4707,2007-04-16 20:42:00,Karrmann,-1,2007,10422
1208,1208,4706,2007-04-16 20:42:00,Alkivar,-5,2007,10417
1209,1209,4705,2007-04-16 20:42:00,Gdo01,-15,2007,10402
1210,1210,4704,2007-04-16 20:42:00,Ektar,0,2007,10402
1211,1211,4703,2007-04-16 20:42:00,MidnightSwinga,150,2007,10552
1212,1212,4702,2007-04-16 20:42:00,Nishkid64,-76,2007,10476
1213,1213,4701,2007-04-16 20:42:00,Katalaveno,265,2007,10741
1214,1214,4700,2007-04-16 20:42:00,Karrmann,-280,2007,10461
1215,1217,4697,2007-04-16 20:43:00,Nishkid64,107,2007,10568
1216,1215,4699,2007-04-16 20:43:00,Gdo01,-76,2007,10492
1217,1216,4698,2007-04-16 20:43:00,Karrmann,356,2007,10848
1218,1225,4692,2007-04-16 20:44:00,John Stattic,-135,2007,10713
1219,1218,4689,2007-04-16 20:44:00,Dsf,6,2007,10719
1220,1219,4690,2007-04-16 20:44:00,AEMoreira042281,-8,2007,10711
1221,1220,4691,2007-04-16 20:44:00,Karrmann,0,2007,10711
1222,1221,4688,2007-04-16 20:44:00,Penguinee,-125,2007,10586
1223,1222,4693,2007-04-16 20:44:00,AEMoreira042281,41,2007,10627
1224,1223,4694,2007-04-16 20:44:00,Karrmann,20,2007,10647
1225,1224,4695,2007-04-16 20:44:00,Irdepesca572,0,2007,10647
1226,1226,4696,2007-04-16 20:44:00,Elg26,233,2007,10880
1227,1232,4686,2007-04-16 20:45:00,Penguinee,79,2007,10959
1228,1231,4685,2007-04-16 20:45:00,Raden,0,2007,10959
1229,1230,4687,2007-04-16 20:45:00,Stevenscollege,-265,2007,10694
1230,1233,4684,2007-04-16 20:45:00,Takethemud,11,2007,10705
1231,1228,4682,2007-04-16 20:45:00,Irdepesca572,61,2007,10766
1232,1227,4681,2007-04-16 20:45:00,Kizor,189,2007,10955
1233,1229,4683,2007-04-16 20:45:00,AEMoreira042281,-405,2007,10550
1234,1240,4677,2007-04-16 20:46:00,Karrmann,95,2007,10645
1235,1236,4676,2007-04-16 20:46:00,Karrmann,0,2007,10645
1236,1241,4679,2007-04-16 20:46:00,Aranth,0,2007,10645
1237,1239,4680,2007-04-16 20:46:00,John Reaves,10,2007,10655
1238,1234,4673,2007-04-16 20:46:00,Slavik0329,25,2007,10680
1239,1237,4674,2007-04-16 20:46:00,Digitalhen,-68,2007,10612
1240,1235,4675,2007-04-16 20:46:00,Rtcpenguin,-19,2007,10593
1241,1238,4678,2007-04-16 20:46:00,Raden,0,2007,10593
1242,1242,4672,2007-04-16 20:47:00,Karrmann,-1,2007,10592
1243,1243,4671,2007-04-16 20:47:00,Karrmann,7,2007,10599
1244,1244,4670,2007-04-16 20:47:00,John Stattic,0,2007,10599
1245,1245,4669,2007-04-16 20:47:00,Gdo01,-7,2007,10592
1246,1246,4668,2007-04-16 20:47:00,John Stattic,-77,2007,10515
1247,1247,4663,2007-04-16 20:48:00,Ryanluck,197,2007,10712
1248,1248,4664,2007-04-16 20:48:00,Kizor,96,2007,10808
1249,1249,4666,2007-04-16 20:48:00,O^O,15,2007,10823
1250,1250,4667,2007-04-16 20:48:00,Kaldari,-332,2007,10491
1251,1251,4665,2007-04-16 20:48:00,Bolivian Unicyclist,-20,2007,10471
1252,1255,4659,2007-04-16 20:49:00,Iamdeadnow,0,2007,10471
1253,1254,4660,2007-04-16 20:49:00,Amalga,0,2007,10471
1254,1256,4658,2007-04-16 20:49:00,Kizor,-11,2007,10460
1255,1252,4662,2007-04-16 20:49:00,Gdo01,0,2007,10460
1256,1253,4661,2007-04-16 20:49:00,Getinthek,171,2007,10631
1257,1257,4652,2007-04-16 20:50:00,AEMoreira042281,23,2007,10654
1258,1258,4653,2007-04-16 20:50:00,Kaveh,-263,2007,10391
1259,1259,4656,2007-04-16 20:50:00,John Stattic,0,2007,10391
1260,1260,4655,2007-04-16 20:50:00,Karrmann,29,2007,10420
1261,1261,4654,2007-04-16 20:50:00,Gdo01,-5,2007,10415
1262,1268,4648,2007-04-16 20:51:00,Penguinee,2,2007,10417
1263,1267,4650,2007-04-16 20:51:00,Penguinee,7,2007,10424
1264,1266,4649,2007-04-16 20:51:00,Irdepesca572,-26,2007,10398
1265,1264,4647,2007-04-16 20:51:00,Gdo01,56,2007,10454
1266,1263,4645,2007-04-16 20:51:00,Ektar,0,2007,10454
1267,1262,4646,2007-04-16 20:51:00,Nishkid64,-32,2007,10422
1268,1265,4651,2007-04-16 20:51:00,O^O,1,2007,10423
1269,1269,4644,2007-04-16 20:52:00,Kizor,125,2007,10548
1270,1270,4643,2007-04-16 20:52:00,Penguinee,-7,2007,10541
1271,1271,4642,2007-04-16 20:52:00,Joebengo,10,2007,10551
1272,1276,4638,2007-04-16 20:53:00,ElKevbo,-4,2007,10547
1273,1277,4639,2007-04-16 20:53:00,Abe Lincoln,80,2007,10627
1274,1275,4641,2007-04-16 20:53:00,Marcika,22,2007,10649
1275,1278,4640,2007-04-16 20:53:00,Nishkid64,20,2007,10669
1276,1273,4634,2007-04-16 20:53:00,Kizor,145,2007,10814
1277,1272,4635,2007-04-16 20:53:00,Opertinicy,-8,2007,10806
1278,1274,4636,2007-04-16 20:53:00,MidnightSwinga,-72,2007,10734
1279,1279,4637,2007-04-16 20:53:00,Ryulong,0,2007,10734
1280,1284,4629,2007-04-16 20:54:00,Natwebb,0,2007,10734
1281,1285,4628,2007-04-16 20:54:00,Nishkid64,-91,2007,10643
1282,1283,4630,2007-04-16 20:54:00,Irdepesca572,19,2007,10662
1283,1281,4632,2007-04-16 20:54:00,Greensprout,1,2007,10663
1284,1282,4631,2007-04-16 20:54:00,AEMoreira042281,169,2007,10832
1285,1280,4633,2007-04-16 20:54:00,Opertinicy,2,2007,10834
1286,1286,4622,2007-04-16 20:55:00,Abe Lincoln,-96,2007,10738
1287,1287,4623,2007-04-16 20:55:00,Ryulong,0,2007,10738
1288,1288,4627,2007-04-16 20:55:00,Nishkid64,90,2007,10828
1289,1289,4625,2007-04-16 20:55:00,Jarsonic,7,2007,10835
1290,1290,4626,2007-04-16 20:55:00,AEMoreira042281,0,2007,10835
1291,1291,4624,2007-04-16 20:55:00,Kizor,29,2007,10864
1292,1298,4621,2007-04-16 20:56:00,Abe Lincoln,-53,2007,10811
1293,1297,4618,2007-04-16 20:56:00,Abe Lincoln,-36,2007,10775
1294,1296,4620,2007-04-16 20:56:00,Nishkid64,1,2007,10776
1295,1292,4615,2007-04-16 20:56:00,Karrmann,20,2007,10796
1296,1294,4617,2007-04-16 20:56:00,AEMoreira042281,-8,2007,10788
1297,1293,4616,2007-04-16 20:56:00,Zone46,11,2007,10799
1298,1295,4619,2007-04-16 20:56:00,Jarsonic,-20,2007,10779
1299,1300,4614,2007-04-16 20:57:00,Abe Lincoln,23,2007,10802
1300,1299,4613,2007-04-16 20:57:00,O^O,1,2007,10803
1301,1301,4612,2007-04-16 20:57:00,Penguinee,51,2007,10854
1302,1303,4610,2007-04-16 20:58:00,AnonymousPedobear,126,2007,10980
1303,1302,4611,2007-04-16 20:58:00,Ravedave,-133,2007,10847
1304,1304,4605,2007-04-16 20:59:00,Yaanch,116,2007,10963
1305,1305,4606,2007-04-16 20:59:00,Karrmann,-126,2007,10837
1306,1306,4609,2007-04-16 20:59:00,AEMoreira042281,-65,2007,10772
1307,1307,4608,2007-04-16 20:59:00,Mithent,5,2007,10777
1308,1308,4607,2007-04-16 20:59:00,AEMoreira042281,0,2007,10777
1309,1311,4602,2007-04-16 21:00:00,Adityasarin,91,2007,10868
1310,1309,4604,2007-04-16 21:00:00,Pedro,9,2007,10877
1311,1310,4603,2007-04-16 21:00:00,Iamdeadnow,22,2007,10899
1312,1312,4601,2007-04-16 21:00:00,Gdo01,-22,2007,10877
1313,1313,4600,2007-04-16 21:00:00,I already forgot,-91,2007,10786
1314,1317,4596,2007-04-16 21:01:00,Mithent,-12,2007,10774
1315,1316,4597,2007-04-16 21:01:00,Worldunderblood,-40,2007,10734
1316,1318,4595,2007-04-16 21:01:00,Kizor,-101,2007,10633
1317,1314,4599,2007-04-16 21:01:00,Famousdog,64,2007,10697
1318,1315,4598,2007-04-16 21:01:00,I already forgot,-64,2007,10633
1319,1319,4594,2007-04-16 21:01:00,Ike9898,-7,2007,10626
1320,1326,4593,2007-04-16 21:02:00,Mjurney,-1,2007,10625
1321,1325,4590,2007-04-16 21:02:00,Raineybt,1,2007,10626
1322,1323,4591,2007-04-16 21:02:00,Mithent,-11,2007,10615
1323,1324,4592,2007-04-16 21:02:00,Karrmann,15,2007,10630
1324,1322,4587,2007-04-16 21:02:00,CLWE,-1,2007,10629
1325,1321,4589,2007-04-16 21:02:00,Kenyon,-11,2007,10618
1326,1320,4588,2007-04-16 21:02:00,MidnightSwinga,43,2007,10661
1327,1327,4584,2007-04-16 21:03:00,Moncrief,-371,2007,10290
1328,1328,4585,2007-04-16 21:03:00,Xuxunette,9,2007,10299
1329,1329,4586,2007-04-16 21:03:00,Fethers,0,2007,10299
1330,1330,4583,2007-04-16 21:04:00,Futurebird,69,2007,10368
1331,1332,4581,2007-04-16 21:05:00,Netscott,1,2007,10369
1332,1333,4580,2007-04-16 21:05:00,Kamalesh9,101,2007,10470
1333,1331,4582,2007-04-16 21:05:00,JohnnyBGood,3,2007,10473
1334,1334,4573,2007-04-16 21:06:00,John Stattic,1,2007,10474
1335,1335,4575,2007-04-16 21:06:00,AnonymousPedobear,7,2007,10481
1336,1336,4574,2007-04-16 21:06:00,Kwan-Trill,39,2007,10520
1337,1337,4578,2007-04-16 21:06:00,Emerrill,0,2007,10520
1338,1338,4579,2007-04-16 21:06:00,Penguinee,23,2007,10543
1339,1339,4576,2007-04-16 21:06:00,SuperJ9587,-15,2007,10528
1340,1340,4577,2007-04-16 21:06:00,MattieTK,4,2007,10532
1341,1345,4568,2007-04-16 21:07:00,JohnnyBGood,3,2007,10535
1342,1344,4569,2007-04-16 21:07:00,Rit83,0,2007,10535
1343,1341,4572,2007-04-16 21:07:00,Famousdog,55,2007,10590
1344,1342,4571,2007-04-16 21:07:00,Ike9898,0,2007,10590
1345,1343,4570,2007-04-16 21:07:00,O^O,-6,2007,10584
1346,1346,4563,2007-04-16 21:08:00,John Stattic,-3,2007,10581
1347,1347,4562,2007-04-16 21:08:00,24.1.152.153,1,2007,10582
1348,1348,4564,2007-04-16 21:08:00,NoPetrol,-3,2007,10579
1349,1349,4566,2007-04-16 21:08:00,SuperJ9587,0,2007,10579
1350,1350,4565,2007-04-16 21:08:00,Tukkaatje,2,2007,10581
1351,1351,4567,2007-04-16 21:08:00,66.74.150.180,-2,2007,10579
1352,1352,4561,2007-04-16 21:09:00,JohnnyBGood,3,2007,10582
1353,1353,4560,2007-04-16 21:09:00,Bilbo411,-61,2007,10521
1354,1354,4559,2007-04-16 21:09:00,Tomasboij,-5,2007,10516
1355,1355,4558,2007-04-16 21:09:00,Ronnotel,-39,2007,10477
1356,1356,4557,2007-04-16 21:09:00,Kenyon,14,2007,10491
1357,1357,4556,2007-04-16 21:09:00,Ike9898,0,2007,10491
1358,1362,4554,2007-04-16 21:10:00,24.127.49.22,0,2007,10491
1359,1361,4553,2007-04-16 21:10:00,147.31.246.236,-14,2007,10477
1360,1363,4555,2007-04-16 21:10:00,66.74.150.180,39,2007,10516
1361,1359,4550,2007-04-16 21:10:00,Penguinee,166,2007,10682
1362,1358,4549,2007-04-16 21:10:00,198.124.16.2,1,2007,10683
1363,1360,4551,2007-04-16 21:10:00,71.8.47.159,1,2007,10684
1364,1364,4552,2007-04-16 21:10:00,Nishkid64,61,2007,10745
1365,1372,4541,2007-04-16 21:11:00,John Stattic,-3,2007,10742
1366,1370,4545,2007-04-16 21:11:00,Penguinee,5,2007,10747
1367,1373,4547,2007-04-16 21:11:00,71.8.47.159,-1,2007,10746
1368,1369,4546,2007-04-16 21:11:00,JohnnyBGood,5,2007,10751
1369,1371,4548,2007-04-16 21:11:00,Futurebird,384,2007,11135
1370,1367,4544,2007-04-16 21:11:00,76.97.216.145,111,2007,11246
1371,1365,4543,2007-04-16 21:11:00,207.246.173.114,198,2007,11444
1372,1368,4540,2007-04-16 21:11:00,67.86.198.179,-8,2007,11436
1373,1366,4542,2007-04-16 21:11:00,63.120.68.39,0,2007,11436
1374,1383,4534,2007-04-16 21:12:00,FunPika,0,2007,11436
1375,1381,4537,2007-04-16 21:12:00,PIrish,8,2007,11444
1376,1380,4536,2007-04-16 21:12:00,Penguinee,7,2007,11451
1377,1379,4535,2007-04-16 21:12:00,69.234.227.48,44,2007,11495
1378,1382,4538,2007-04-16 21:12:00,64.37.159.196,-2,2007,11493
1379,1377,4533,2007-04-16 21:12:00,Nishkid64,-5,2007,11488
1380,1376,4532,2007-04-16 21:12:00,Awartha,4,2007,11492
1381,1375,4530,2007-04-16 21:12:00,Tariqabjotu,0,2007,11492
1382,1374,4539,2007-04-16 21:12:00,Smokefan2007,361,2007,11853
1383,1378,4531,2007-04-16 21:12:00,Tirerim,108,2007,11961
1384,1390,4522,2007-04-16 21:13:00,O^O,5,2007,11966
1385,1384,4528,2007-04-16 21:13:00,Dsf,-10,2007,11956
1386,1385,4527,2007-04-16 21:13:00,JohnnyBGood,3,2007,11959
1387,1386,4526,2007-04-16 21:13:00,Nishkid64,67,2007,12026
1388,1387,4525,2007-04-16 21:13:00,AnonymousPedobear,8,2007,12034
1389,1388,4524,2007-04-16 21:13:00,Elliskev,0,2007,12034
1390,1389,4523,2007-04-16 21:13:00,Penguinee,7,2007,12041
1391,1391,4529,2007-04-16 21:13:00,John Stattic,-3,2007,12038
1392,1393,4516,2007-04-16 21:14:00,JohnnyBGood,3,2007,12041
1393,1397,4521,2007-04-16 21:14:00,John Stattic,-3,2007,12038
1394,1396,4519,2007-04-16 21:14:00,Gdo01,0,2007,12038
1395,1392,4517,2007-04-16 21:14:00,Futurebird,388,2007,12426
1396,1394,4518,2007-04-16 21:14:00,O^O,-6,2007,12420
1397,1395,4520,2007-04-16 21:14:00,Penguinee,1,2007,12421
1398,1398,4512,2007-04-16 21:15:00,John Stattic,-3,2007,12418
1399,1399,4515,2007-04-16 21:15:00,Derickdavidjones,1,2007,12419
1400,1400,4514,2007-04-16 21:15:00,Tirerim,0,2007,12419
1401,1401,4513,2007-04-16 21:15:00,Smokefan2007,361,2007,12780
1402,1402,4511,2007-04-16 21:16:00,Kenyon,23,2007,12803
1403,1403,4510,2007-04-16 21:16:00,SeaFlat,1,2007,12804
1404,1404,4509,2007-04-16 21:16:00,JohnnyBGood,3,2007,12807
1405,1409,4506,2007-04-16 21:17:00,King Bee,0,2007,12807
1406,1408,4508,2007-04-16 21:17:00,Georgegraha,-13,2007,12794
1407,1405,4505,2007-04-16 21:17:00,Nishkid64,27,2007,12821
1408,1406,4504,2007-04-16 21:17:00,Zehly,37,2007,12858
1409,1407,4507,2007-04-16 21:17:00,Kenyon,4,2007,12862
1410,1410,4503,2007-04-16 21:18:00,Cocoaguy,2,2007,12864
1411,1411,4502,2007-04-16 21:18:00,Derickdavidjones,0,2007,12864
1412,1412,4501,2007-04-16 21:18:00,Gdo01,-19,2007,12845
1413,1415,4498,2007-04-16 21:19:00,Irdepesca572,36,2007,12881
1414,1416,4497,2007-04-16 21:19:00,Krejjare2k8,15,2007,12896
1415,1414,4499,2007-04-16 21:19:00,Derickdavidjones,0,2007,12896
1416,1413,4500,2007-04-16 21:19:00,Jmlk17,1,2007,12897
1417,1417,4492,2007-04-16 21:20:00,Nishkid64,89,2007,12986
1418,1418,4493,2007-04-16 21:20:00,Famguy231,20,2007,13006
1419,1419,4495,2007-04-16 21:20:00,Smokefan2007,0,2007,13006
1420,1420,4496,2007-04-16 21:20:00,John Stattic,4,2007,13010
1421,1421,4494,2007-04-16 21:20:00,AEMoreira042281,0,2007,13010
1422,1422,4491,2007-04-16 21:22:00,Tomasboij,-25,2007,12985
1423,1423,4490,2007-04-16 21:22:00,Nishkid64,-77,2007,12908
1424,1427,4486,2007-04-16 21:23:00,Elliskev,-28,2007,12880
1425,1430,4483,2007-04-16 21:23:00,Gdo01,-1,2007,12879
1426,1429,4484,2007-04-16 21:23:00,JohnnyBGood,-4,2007,12875
1427,1428,4485,2007-04-16 21:23:00,I already forgot,46,2007,12921
1428,1425,4488,2007-04-16 21:23:00,SigmaSquared,1,2007,12922
1429,1424,4489,2007-04-16 21:23:00,Famguy231,63,2007,12985
1430,1426,4487,2007-04-16 21:23:00,Nzk,6,2007,12991
1431,1434,4481,2007-04-16 21:24:00,Cerebrus13,4,2007,12995
1432,1431,4478,2007-04-16 21:24:00,Cocoaguy,10,2007,13005
1433,1432,4479,2007-04-16 21:24:00,Efrafra,12,2007,13017
1434,1433,4482,2007-04-16 21:24:00,I already forgot,0,2007,13017
1435,1435,4480,2007-04-16 21:24:00,John Stattic,-1,2007,13016
1436,1437,4476,2007-04-16 21:25:00,Rdfox 76,-1,2007,13015
1437,1441,4472,2007-04-16 21:25:00,Zachlac,480,2007,13495
1438,1440,4473,2007-04-16 21:25:00,FAH1223,23,2007,13518
1439,1436,4477,2007-04-16 21:25:00,Cerebrus13,0,2007,13518
1440,1438,4475,2007-04-16 21:25:00,Cdpierce,-72,2007,13446
1441,1439,4474,2007-04-16 21:25:00,Dantadd,-3,2007,13443
1442,1442,4469,2007-04-16 21:26:00,Nzk,32,2007,13475
1443,1443,4470,2007-04-16 21:26:00,John Stattic,3,2007,13478
1444,1444,4471,2007-04-16 21:26:00,Xuxunette,0,2007,13478
1445,1445,4466,2007-04-16 21:27:00,Vsb,28,2007,13506
1446,1446,4468,2007-04-16 21:27:00,SPNirology,-1,2007,13505
1447,1447,4467,2007-04-16 21:27:00,Rdfox 76,-1,2007,13504
1448,1451,4463,2007-04-16 21:28:00,Soultaco,-23,2007,13481
1449,1450,4464,2007-04-16 21:28:00,Kenyon,0,2007,13481
1450,1448,4462,2007-04-16 21:28:00,I already forgot,33,2007,13514
1451,1449,4465,2007-04-16 21:28:00,Mijakai,-10,2007,13504
1452,1455,4458,2007-04-16 21:29:00,Karrmann,-3,2007,13501
1453,1452,4461,2007-04-16 21:29:00,Elliskev,-1,2007,13500
1454,1453,4460,2007-04-16 21:29:00,Kevin Lakhani,262,2007,13762
1455,1454,4459,2007-04-16 21:29:00,Tomasboij,2,2007,13764
1456,1456,4457,2007-04-16 21:29:00,Eltri85~enwiki,47,2007,13811
1457,1457,4455,2007-04-16 21:30:00,I already forgot,11,2007,13822
1458,1458,4456,2007-04-16 21:30:00,Nishkid64,-10,2007,13812
1459,1463,4449,2007-04-16 21:31:00,John Reaves,-478,2007,13334
1460,1462,4450,2007-04-16 21:31:00,Nishkid64,0,2007,13334
1461,1464,4448,2007-04-16 21:31:00,Kizor,9,2007,13343
1462,1460,4452,2007-04-16 21:31:00,SPNirology,-1,2007,13342
1463,1459,4453,2007-04-16 21:31:00,Famguy231,-63,2007,13279
1464,1461,4451,2007-04-16 21:31:00,Bdj95,-14,2007,13265
1465,1465,4454,2007-04-16 21:31:00,Kizor,6,2007,13271
1466,1466,4447,2007-04-16 21:32:00,Rdfox 76,1,2007,13272
1467,1469,4446,2007-04-16 21:33:00,Bdj95,24,2007,13296
1468,1470,4444,2007-04-16 21:33:00,Ball&Chain,-92,2007,13204
1469,1467,4443,2007-04-16 21:33:00,John Stattic,-25,2007,13179
1470,1468,4445,2007-04-16 21:33:00,Freakipedia69,54,2007,13233
1471,1471,4442,2007-04-16 21:34:00,Moncrief,8,2007,13241
1472,1472,4441,2007-04-16 21:34:00,SPNirology,0,2007,13241
1473,1473,4440,2007-04-16 21:34:00,Bdj95,24,2007,13265
1474,1474,4439,2007-04-16 21:34:00,Nishkid64,-54,2007,13211
1475,1475,4438,2007-04-16 21:35:00,Mijakai,0,2007,13211
1476,1476,4437,2007-04-16 21:35:00,Rdfox 76,0,2007,13211
1477,1477,4436,2007-04-16 21:35:00,Kenyon,-2,2007,13209
1478,1478,4434,2007-04-16 21:36:00,Abynion08,24,2007,13233
1479,1479,4435,2007-04-16 21:36:00,Kitia,80,2007,13313
1480,1483,4430,2007-04-16 21:37:00,I already forgot,54,2007,13367
1481,1482,4431,2007-04-16 21:37:00,Mijakai,12,2007,13379
1482,1481,4432,2007-04-16 21:37:00,Shoeofdeath,-24,2007,13355
1483,1480,4433,2007-04-16 21:37:00,Bumcheekcity,94,2007,13449
1484,1484,4429,2007-04-16 21:38:00,Markie,15,2007,13464
1485,1485,4428,2007-04-16 21:38:00,Haakon,0,2007,13464
1486,1486,4427,2007-04-16 21:38:00,Alison,-165,2007,13299
1487,1487,4426,2007-04-16 21:38:00,Efrafra,6,2007,13305
1488,1488,4425,2007-04-16 21:39:00,Kevin Lakhani,118,2007,13423
1489,1489,4422,2007-04-16 21:40:00,Chunky Rice,-6,2007,13417
1490,1490,4424,2007-04-16 21:40:00,Kevin Lakhani,12,2007,13429
1491,1491,4423,2007-04-16 21:40:00,Donald Hosek,0,2007,13429
1492,1493,4421,2007-04-16 21:41:00,Adambro,9,2007,13438
1493,1492,4420,2007-04-16 21:41:00,Xuxunette,-10,2007,13428
1494,1494,4418,2007-04-16 21:42:00,I already forgot,46,2007,13474
1495,1495,4419,2007-04-16 21:42:00,Yksin,8,2007,13482
1496,1496,4417,2007-04-16 21:42:00,Chunky Rice,-80,2007,13402
1497,1497,4416,2007-04-16 21:43:00,ColdCase,188,2007,13590
1498,1502,4411,2007-04-16 21:44:00,Karrmann,-47,2007,13543
1499,1498,4415,2007-04-16 21:44:00,Irdepesca572,-11,2007,13532
1500,1499,4414,2007-04-16 21:44:00,RichardWeiss,24,2007,13556
1501,1500,4413,2007-04-16 21:44:00,ColdCase,5,2007,13561
1502,1501,4412,2007-04-16 21:44:00,Yaf,20,2007,13581
1503,1505,4409,2007-04-16 21:45:00,Xyzzyplugh,54,2007,13635
1504,1504,4410,2007-04-16 21:45:00,Zarathrustra,262,2007,13897
1505,1503,4408,2007-04-16 21:45:00,Yaf,35,2007,13932
1506,1506,4406,2007-04-16 21:46:00,RichardWeiss,11,2007,13943
1507,1507,4407,2007-04-16 21:46:00,Arunkumar,-149,2007,13794
1508,1511,4402,2007-04-16 21:47:00,Chunky Rice,-262,2007,13532
1509,1508,4405,2007-04-16 21:47:00,O^O,-180,2007,13352
1510,1509,4404,2007-04-16 21:47:00,Beyoncek06,46,2007,13398
1511,1510,4403,2007-04-16 21:47:00,Cariniabean,-1,2007,13397
1512,1514,4400,2007-04-16 21:48:00,Tomasboij,-3,2007,13394
1513,1515,4399,2007-04-16 21:48:00,Bobzilla1,4,2007,13398
1514,1512,4398,2007-04-16 21:48:00,Inoculatedcities,-1,2007,13397
1515,1513,4401,2007-04-16 21:48:00,Netscott,-46,2007,13351
1516,1517,4397,2007-04-16 21:49:00,Cmcnicoll,253,2007,13604
1517,1516,4396,2007-04-16 21:49:00,Inoculatedcities,0,2007,13604
1518,1518,4393,2007-04-16 21:50:00,Maxanova,-46,2007,13558
1519,1519,4395,2007-04-16 21:50:00,ColdCase,11,2007,13569
1520,1520,4394,2007-04-16 21:50:00,Kenyon,21,2007,13590
1521,1521,4392,2007-04-16 21:51:00,Sertrel,165,2007,13755
1522,1522,4391,2007-04-16 21:51:00,Gplpark92,14,2007,13769
1523,1523,4390,2007-04-16 21:51:00,Walterk29,0,2007,13769
1524,1524,4389,2007-04-16 21:51:00,Netscott,-14,2007,13755
1525,1525,4388,2007-04-16 21:51:00,MagneticFlux,-2,2007,13753
1526,1526,4387,2007-04-16 21:51:00,Walterk29,-1,2007,13752
1527,1533,4385,2007-04-16 21:52:00,MisterSheik,-5,2007,13747
1528,1532,4384,2007-04-16 21:52:00,Moncrief,19,2007,13766
1529,1531,4386,2007-04-16 21:52:00,Netscott,14,2007,13780
1530,1528,4381,2007-04-16 21:52:00,MisterSheik,1,2007,13781
1531,1529,4382,2007-04-16 21:52:00,Zarathrustra,0,2007,13781
1532,1527,4380,2007-04-16 21:52:00,President David Palmer,2,2007,13783
1533,1530,4383,2007-04-16 21:52:00,Alex43223,2,2007,13785
1534,1537,4377,2007-04-16 21:53:00,O^O,-178,2007,13607
1535,1534,4375,2007-04-16 21:53:00,John Stattic,-1,2007,13606
1536,1535,4379,2007-04-16 21:53:00,O^O,-6,2007,13600
1537,1536,4378,2007-04-16 21:53:00,Tomasboij,-61,2007,13539
1538,1538,4376,2007-04-16 21:53:00,WxGopher,27,2007,13566
1539,1540,4374,2007-04-16 21:54:00,MisterSheik,-7,2007,13559
1540,1539,4373,2007-04-16 21:54:00,JohnnyBGood,3,2007,13562
1541,1541,4367,2007-04-16 21:55:00,RichardWeiss,26,2007,13588
1542,1542,4368,2007-04-16 21:55:00,Cmcnicoll,125,2007,13713
1543,1543,4372,2007-04-16 21:55:00,WxGopher,40,2007,13753
1544,1544,4370,2007-04-16 21:55:00,MagneticFlux,14,2007,13767
1545,1545,4371,2007-04-16 21:55:00,Moncrief,8,2007,13775
1546,1546,4369,2007-04-16 21:55:00,Xuxunette,46,2007,13821
1547,1547,4366,2007-04-16 21:56:00,Daveswagon,0,2007,13821
1548,1548,4365,2007-04-16 21:56:00,Netscott,-2,2007,13819
1549,1549,4364,2007-04-16 21:56:00,Acalamari,-1,2007,13818
1550,1551,4360,2007-04-16 21:57:00,O^O,-53,2007,13765
1551,1554,4361,2007-04-16 21:57:00,RichardWeiss,4,2007,13769
1552,1553,4363,2007-04-16 21:57:00,Rdfox 76,3,2007,13772
1553,1550,4359,2007-04-16 21:57:00,Kenyon,32,2007,13804
1554,1552,4362,2007-04-16 21:57:00,ColdCase,23,2007,13827
1555,1555,4358,2007-04-16 21:58:00,Speasley,-70,2007,13757
1556,1556,4357,2007-04-16 21:58:00,Daveswagon,-1,2007,13756
1557,1557,4356,2007-04-16 21:58:00,Ribonucleic,340,2007,14096
1558,1558,4355,2007-04-16 21:58:00,Kenyon,19,2007,14115
1559,1559,4354,2007-04-16 21:59:00,Ribonucleic,31,2007,14146
1560,1560,4353,2007-04-16 21:59:00,Tomasboij,-7,2007,14139
1561,1565,4350,2007-04-16 22:00:00,Ribonucleic,52,2007,14191
1562,1564,4352,2007-04-16 22:00:00,Daveswagon,-5,2007,14186
1563,1562,4349,2007-04-16 22:00:00,Acalamari,-1,2007,14185
1564,1563,4351,2007-04-16 22:00:00,WxGopher,110,2007,14295
1565,1561,4348,2007-04-16 22:00:00,Cmcnicoll,7,2007,14302
1566,1566,4347,2007-04-16 22:01:00,Kenyon,3,2007,14305
1567,1567,4346,2007-04-16 22:01:00,NewTestLeper79,0,2007,14305
1568,1568,4345,2007-04-16 22:01:00,ColdCase,24,2007,14329
1569,1569,4344,2007-04-16 22:01:00,WxGopher,2,2007,14331
1570,1570,4343,2007-04-16 22:01:00,Ribonucleic,44,2007,14375
1571,1571,4342,2007-04-16 22:01:00,Tomasboij,-2,2007,14373
1572,1572,4341,2007-04-16 22:02:00,Kenyon,-239,2007,14134
1573,1573,4340,2007-04-16 22:02:00,I already forgot,3,2007,14137
1574,1576,4339,2007-04-16 22:03:00,SillyWalksMinister,-12,2007,14125
1575,1575,4338,2007-04-16 22:03:00,I already forgot,30,2007,14155
1576,1574,4337,2007-04-16 22:03:00,Lukobe,1,2007,14156
1577,1577,4336,2007-04-16 22:04:00,John Stattic,5,2007,14161
1578,1578,4335,2007-04-16 22:05:00,Kenyon,14,2007,14175
1579,1579,4334,2007-04-16 22:05:00,CLWE,0,2007,14175
1580,1580,4333,2007-04-16 22:05:00,Chunky Rice,-467,2007,13708
1581,1581,4332,2007-04-16 22:06:00,Kenyon,3,2007,13711
1582,1582,4331,2007-04-16 22:06:00,Shandy man,51,2007,13762
1583,1583,4330,2007-04-16 22:06:00,CLWE,55,2007,13817
1584,1584,4329,2007-04-16 22:06:00,I already forgot,99,2007,13916
1585,1585,4328,2007-04-16 22:06:00,Shandy man,-51,2007,13865
1586,1589,4325,2007-04-16 22:07:00,Shandy man,2,2007,13867
1587,1588,4327,2007-04-16 22:07:00,Tim Q. Wells,1,2007,13868
1588,1586,4324,2007-04-16 22:07:00,Dante Alighieri,1,2007,13869
1589,1587,4326,2007-04-16 22:07:00,Efrafra,-69,2007,13800
1590,1590,4322,2007-04-16 22:08:00,Kenyon,-16,2007,13784
1591,1591,4319,2007-04-16 22:08:00,John Stattic,5,2007,13789
1592,1592,4323,2007-04-16 22:08:00,Jeltz,-1,2007,13788
1593,1593,4321,2007-04-16 22:08:00,NeoNecronox,10,2007,13798
1594,1594,4320,2007-04-16 22:08:00,Dante Alighieri,-20,2007,13778
1595,1595,4318,2007-04-16 22:09:00,Mahanga,39,2007,13817
1596,1596,4317,2007-04-16 22:09:00,Ytud Fo Llac,-10,2007,13807
1597,1597,4316,2007-04-16 22:10:00,I already forgot,39,2007,13846
1598,1599,4314,2007-04-16 22:11:00,WxGopher,71,2007,13917
1599,1598,4315,2007-04-16 22:11:00,Kevin Lakhani,0,2007,13917
1600,1600,4308,2007-04-16 22:12:00,Chmod007,-114,2007,13803
1601,1601,4309,2007-04-16 22:12:00,AEMoreira042281,52,2007,13855
1602,1602,4310,2007-04-16 22:12:00,Kevin Lakhani,6,2007,13861
1603,1603,4312,2007-04-16 22:12:00,Kenyon,-76,2007,13785
1604,1604,4313,2007-04-16 22:12:00,Silentjudas,34,2007,13819
1605,1605,4311,2007-04-16 22:12:00,4daysold,-3,2007,13816
1606,1607,4306,2007-04-16 22:13:00,Kevin Lakhani,12,2007,13828
1607,1606,4307,2007-04-16 22:13:00,Dsf,-29,2007,13799
1608,1610,4303,2007-04-16 22:14:00,Silentjudas,29,2007,13828
1609,1608,4305,2007-04-16 22:14:00,Moncrief,0,2007,13828
1610,1609,4304,2007-04-16 22:14:00,Matt Gies,23,2007,13851
1611,1611,4297,2007-04-16 22:15:00,I already forgot,131,2007,13982
1612,1612,4298,2007-04-16 22:15:00,JohnnyBGood,3,2007,13985
1613,1613,4300,2007-04-16 22:15:00,Kenyon,186,2007,14171
1614,1614,4301,2007-04-16 22:15:00,RobNS,28,2007,14199
1615,1615,4302,2007-04-16 22:15:00,A Train,-29,2007,14170
1616,1616,4299,2007-04-16 22:15:00,The Anome,-4,2007,14166
1617,1621,4292,2007-04-16 22:16:00,Bobxii,1,2007,14167
1618,1619,4294,2007-04-16 22:16:00,RobNS,191,2007,14358
1619,1620,4293,2007-04-16 22:16:00,Awillcox,13,2007,14371
1620,1617,4296,2007-04-16 22:16:00,Kenyon,0,2007,14371
1621,1618,4295,2007-04-16 22:16:00,Moncrief,1,2007,14372
1622,1622,4287,2007-04-16 22:17:00,Yksin,-234,2007,14138
1623,1623,4288,2007-04-16 22:17:00,Kenyon,1,2007,14139
1624,1624,4290,2007-04-16 22:17:00,The Anome,-3,2007,14136
1625,1625,4291,2007-04-16 22:17:00,I already forgot,42,2007,14178
1626,1626,4289,2007-04-16 22:17:00,RobNS,19,2007,14197
1627,1627,4286,2007-04-16 22:18:00,President David Palmer,3,2007,14200
1628,1628,4285,2007-04-16 22:18:00,Silentjudas,57,2007,14257
1629,1629,4284,2007-04-16 22:18:00,Hdt83,-57,2007,14200
1630,1631,4282,2007-04-16 22:19:00,Chanlyn,4,2007,14204
1631,1630,4283,2007-04-16 22:19:00,Downwards,3,2007,14207
1632,1632,4281,2007-04-16 22:20:00,CLWE,-1,2007,14206
1633,1633,4280,2007-04-16 22:20:00,Timothyarnold85,-11,2007,14195
1634,1634,4279,2007-04-16 22:20:00,Ravedave,45,2007,14240
1635,1635,4277,2007-04-16 22:21:00,Chanlyn,7,2007,14247
1636,1636,4278,2007-04-16 22:21:00,Timothyarnold85,-11,2007,14236
1637,1637,4276,2007-04-16 22:22:00,RomeW,1,2007,14237
1638,1638,4275,2007-04-16 22:22:00,Lexicon,-1,2007,14236
1639,1639,4274,2007-04-16 22:22:00,Dposse,74,2007,14310
1640,1641,4272,2007-04-16 22:23:00,DragonflySixtyseven,289,2007,14599
1641,1640,4273,2007-04-16 22:23:00,Dposse,47,2007,14646
1642,1642,4271,2007-04-16 22:25:00,Zehly,23,2007,14669
1643,1643,4270,2007-04-16 22:27:00,John Stattic,14,2007,14683
1644,1644,4269,2007-04-16 22:27:00,Miranda,3,2007,14686
1645,1645,4265,2007-04-16 22:28:00,Ikilled007,0,2007,14686
1646,1646,4264,2007-04-16 22:28:00,Ikilled007,-1,2007,14685
1647,1647,4267,2007-04-16 22:28:00,Tagishsimon,-7,2007,14678
1648,1648,4268,2007-04-16 22:28:00,Raden,283,2007,14961
1649,1649,4266,2007-04-16 22:28:00,B,-11,2007,14950
1650,1650,4263,2007-04-16 22:29:00,MoodyGroove,4,2007,14954
1651,1651,4262,2007-04-16 22:30:00,Mr. Toad,-4,2007,14950
1652,1655,4258,2007-04-16 22:31:00,Mayorcheese,113,2007,15063
1653,1654,4259,2007-04-16 22:31:00,Miranda,10,2007,15073
1654,1652,4261,2007-04-16 22:31:00,ColdCase,85,2007,15158
1655,1653,4260,2007-04-16 22:31:00,MoodyGroove,-4,2007,15154
1656,1656,4257,2007-04-16 22:32:00,Chanlyn,7,2007,15161
1657,1657,4256,2007-04-16 22:32:00,Whyaduck,175,2007,15336
1658,1665,4251,2007-04-16 22:33:00,Rammstein1600,54,2007,15390
1659,1663,4254,2007-04-16 22:33:00,JohnnyBGood,5,2007,15395
1660,1662,4252,2007-04-16 22:33:00,Zakhebeone,203,2007,15598
1661,1664,4255,2007-04-16 22:33:00,Chanlyn,-7,2007,15591
1662,1660,4250,2007-04-16 22:33:00,Random832,-91,2007,15500
1663,1659,4249,2007-04-16 22:33:00,Chunky Rice,-40,2007,15460
1664,1658,4248,2007-04-16 22:33:00,FPAtl,1,2007,15461
1665,1661,4253,2007-04-16 22:33:00,Mayorcheese,9,2007,15470
1666,1666,4247,2007-04-16 22:34:00,Moncrief,-202,2007,15268
1667,1667,4246,2007-04-16 22:34:00,Crump78,-75,2007,15193
1668,1668,4245,2007-04-16 22:34:00,Moncrief,24,2007,15217
1669,1669,4244,2007-04-16 22:35:00,Moncrief,0,2007,15217
1670,1673,4242,2007-04-16 22:36:00,Rammstein1600,69,2007,15286
1671,1670,4241,2007-04-16 22:36:00,Moncrief,-54,2007,15232
1672,1671,4240,2007-04-16 22:36:00,Nakon,23,2007,15255
1673,1672,4243,2007-04-16 22:36:00,Nakon,-84,2007,15171
1674,1674,4239,2007-04-16 22:37:00,Hdt83,-69,2007,15102
1675,1676,4237,2007-04-16 22:38:00,Sean William,-32,2007,15070
1676,1675,4238,2007-04-16 22:38:00,Rammstein1600,32,2007,15102
1677,1677,4236,2007-04-16 22:39:00,Xyzzyplugh,-18,2007,15084
1678,1678,4235,2007-04-16 22:39:00,Hdt83,-3,2007,15081
1679,1679,4234,2007-04-16 22:40:00,Anarchonihilist,-1,2007,15080
1680,1680,4233,2007-04-16 22:40:00,Dposse,-111,2007,14969
1681,1681,4232,2007-04-16 22:40:00,EABair,395,2007,15364
1682,1682,4229,2007-04-16 22:41:00,EABair,-394,2007,14970
1683,1683,4231,2007-04-16 22:41:00,Random832,121,2007,15091
1684,1684,4230,2007-04-16 22:41:00,Blondlieut,-2,2007,15089
1685,1687,4227,2007-04-16 22:42:00,Random832,182,2007,15271
1686,1686,4228,2007-04-16 22:42:00,Jordan Elder,1,2007,15272
1687,1685,4226,2007-04-16 22:42:00,Nakon,4,2007,15276
1688,1688,4225,2007-04-16 22:43:00,Zone46,-4,2007,15272
1689,1689,4224,2007-04-16 22:43:00,EABair,291,2007,15563
1690,1690,4223,2007-04-16 22:44:00,Hdt83,221,2007,15784
1691,1691,4222,2007-04-16 22:44:00,Abe.Froman,-1,2007,15783
1692,1692,4219,2007-04-16 22:46:00,Hemlock Martinis,0,2007,15783
1693,1693,4221,2007-04-16 22:46:00,Ribonucleic,0,2007,15783
1694,1694,4220,2007-04-16 22:46:00,Nakon,-11,2007,15772
1695,1695,4218,2007-04-16 22:47:00,Miranda,-2,2007,15770
1696,1696,4217,2007-04-16 22:47:00,Elchupachipmunk,-73,2007,15697
1697,1697,4216,2007-04-16 22:48:00,Miranda,-2,2007,15695
1698,1698,4215,2007-04-16 22:50:00,Ribonucleic,496,2007,16191
1699,1699,4214,2007-04-16 22:51:00,Ribonucleic,-1,2007,16190
1700,1700,4211,2007-04-16 22:52:00,ColdCase,1,2007,16191
1701,1701,4212,2007-04-16 22:52:00,Timothyarnold85,-4,2007,16187
1702,1702,4213,2007-04-16 22:52:00,Miranda,160,2007,16347
1703,1703,4210,2007-04-16 22:53:00,ProphetOfCod,-5,2007,16342
1704,1704,4209,2007-04-16 22:54:00,Ribonucleic,9,2007,16351
1705,1705,4208,2007-04-16 22:54:00,Miranda,-1,2007,16350
1706,1706,4207,2007-04-16 22:54:00,Miranda,10,2007,16360
1707,1707,4206,2007-04-16 22:54:00,Zehly,-467,2007,15893
1708,1709,4204,2007-04-16 22:56:00,Ribonucleic,467,2007,16360
1709,1710,4203,2007-04-16 22:56:00,Violask81976,-79,2007,16281
1710,1708,4205,2007-04-16 22:56:00,Ddngw,79,2007,16360
1711,1711,4202,2007-04-16 22:57:00,Fizbin,-1,2007,16359
1712,1712,4201,2007-04-16 22:58:00,Smokefan2007,391,2007,16750
1713,1713,4200,2007-04-16 22:59:00,Sajman12,-7,2007,16743
1714,1714,4199,2007-04-16 22:59:00,Dyaka,42,2007,16785
1715,1715,4198,2007-04-16 23:00:00,Masamage,-1,2007,16784
1716,1716,4197,2007-04-16 23:00:00,Daveschroeder,0,2007,16784
1717,1717,4196,2007-04-16 23:00:00,VTBassMatt,11,2007,16795
1718,1718,4195,2007-04-16 23:00:00,Daveschroeder,6,2007,16801
1719,1719,4194,2007-04-16 23:01:00,Daveschroeder,-7,2007,16794
1720,1720,4193,2007-04-16 23:01:00,M.U.D.,7,2007,16801
1721,1721,4192,2007-04-16 23:03:00,Dusta619,-14,2007,16787
1722,1722,4188,2007-04-16 23:05:00,Smokefan2007,436,2007,17223
1723,1723,4189,2007-04-16 23:05:00,Ribonucleic,-2,2007,17221
1724,1724,4191,2007-04-16 23:05:00,Narkstraws,92,2007,17313
1725,1725,4190,2007-04-16 23:05:00,Yksin,14,2007,17327
1726,1726,4187,2007-04-16 23:06:00,Chunky Rice,34,2007,17361
1727,1727,4186,2007-04-16 23:06:00,Yksin,-2,2007,17359
1728,1728,4185,2007-04-16 23:06:00,Fifty7,0,2007,17359
1729,1729,4184,2007-04-16 23:06:00,AntiSpamBot,0,2007,17359
1730,1730,4183,2007-04-16 23:07:00,Nishkid64,-5,2007,17354
1731,1731,4182,2007-04-17 04:24:00,Greensprout,-52,2007,17302
1732,1732,4181,2007-04-17 04:25:00,Nordberg3313,-1,2007,17301
1733,1733,4180,2007-04-17 04:27:00,Jrockley,-172,2007,17129
1734,1734,4179,2007-04-17 04:30:00,Oroso,-1,2007,17128
1735,1735,4178,2007-04-17 04:35:00,Greensprout,4,2007,17132
1736,1736,4177,2007-04-17 04:37:00,RichardWeiss,0,2007,17132
1737,1737,4176,2007-04-17 04:38:00,Gdo01,0,2007,17132
1738,1738,4174,2007-04-17 04:39:00,Moncrief,8,2007,17140
1739,1739,4173,2007-04-17 04:39:00,Sdsouza,-3,2007,17137
1740,1740,4175,2007-04-17 04:39:00,Jekteir,-22,2007,17115
1741,1741,4172,2007-04-17 04:40:00,RichardWeiss,1,2007,17116
1742,1742,4171,2007-04-17 04:41:00,Chunky Rice,-1,2007,17115
1743,1743,4170,2007-04-17 04:42:00,RichardWeiss,9,2007,17124
1744,1744,4169,2007-04-17 04:45:00,Gdo01,-28,2007,17096
1745,1745,4168,2007-04-17 04:49:00,K12worker,-9,2007,17087
1746,1746,4167,2007-04-17 04:53:00,EdGl,-29,2007,17058
1747,1747,4166,2007-04-17 05:02:00,Shawn2082,0,2007,17058
1748,1748,4165,2007-04-17 05:03:00,Oroso,0,2007,17058
1749,1749,4164,2007-04-17 05:05:00,Mytwocents,144,2007,17202
1750,1750,4163,2007-04-17 05:07:00,Sdsouza,-1,2007,17201
1751,1751,4162,2007-04-17 05:10:00,HollywoodHawk,15,2007,17216
1752,1752,4161,2007-04-17 05:11:00,Energyfreezer,134,2007,17350
1753,1753,4160,2007-04-17 05:13:00,Rockpocket,4,2007,17354
1754,1754,4159,2007-04-17 05:14:00,Sdsouza,-64,2007,17290
1755,1755,4158,2007-04-17 05:15:00,Rockpocket,-135,2007,17155
1756,1756,4155,2007-04-17 05:17:00,Sdsouza,-17,2007,17138
1757,1757,4157,2007-04-17 05:17:00,Yaf,-24,2007,17114
1758,1758,4156,2007-04-17 05:17:00,Scotts33,2,2007,17116
1759,1759,4154,2007-04-17 05:18:00,Scotts33,42,2007,17158
1760,1760,4153,2007-04-17 05:19:00,Omphaloscope,22,2007,17180
1761,1761,4152,2007-04-17 05:23:00,PalawanOz,222,2007,17402
1762,1762,4151,2007-04-17 05:24:00,Studen~enwiki,-39,2007,17363
1763,1763,4150,2007-04-17 05:24:00,Studen~enwiki,-9,2007,17354
1764,1764,4149,2007-04-17 05:27:00,Studen~enwiki,86,2007,17440
1765,1765,4148,2007-04-17 05:30:00,Greensprout,1,2007,17441
1766,1766,4147,2007-04-17 05:34:00,Ragesoss,46,2007,17487
1767,1767,4146,2007-04-17 05:35:00,MoRsE,20,2007,17507
1768,1768,4145,2007-04-17 05:36:00,Jeeny,4,2007,17511
1769,1769,4144,2007-04-17 05:37:00,SWozniak,-154,2007,17357
1770,1770,4143,2007-04-17 05:42:00,Someones life,-5,2007,17352
1771,1771,4142,2007-04-17 05:43:00,Ryanheitner,407,2007,17759
1772,1772,4141,2007-04-17 05:44:00,Treybien,4,2007,17763
1773,1773,4140,2007-04-17 05:45:00,Treybien,26,2007,17789
1774,1774,4139,2007-04-17 05:46:00,LinguistAtLarge,9,2007,17798
1775,1775,4138,2007-04-17 05:47:00,Scheibenzahl,4,2007,17802
1776,1776,4137,2007-04-17 05:48:00,Treybien,-471,2007,17331
1777,1777,4136,2007-04-17 05:51:00,Ryanheitner,2,2007,17333
1778,1778,4135,2007-04-17 05:54:00,Gameshot911,0,2007,17333
1779,1779,4134,2007-04-17 05:55:00,Justin.fleenor,202,2007,17535
1780,1780,4133,2007-04-17 05:56:00,Jeeny,17,2007,17552
1781,1781,4132,2007-04-17 05:58:00,Yksin,-103,2007,17449
1782,1782,4131,2007-04-17 06:00:00,Yksin,97,2007,17546
1783,1783,4130,2007-04-17 06:01:00,Yksin,0,2007,17546
1784,1784,4128,2007-04-17 06:02:00,Justin.fleenor,25,2007,17571
1785,1785,4129,2007-04-17 06:02:00,Ryulong,-1,2007,17570
1786,1786,4127,2007-04-17 06:04:00,Academic Challenger,-25,2007,17545
1787,1787,4126,2007-04-17 06:06:00,Jeeny,-443,2007,17102
1788,1788,4125,2007-04-17 06:10:00,Sdsouza,38,2007,17140
1789,1789,4124,2007-04-17 06:11:00,Cablebfg,2,2007,17142
1790,1790,4123,2007-04-17 06:11:00,Kenyon,-3,2007,17139
1791,1791,4122,2007-04-17 06:11:00,Natwebb,0,2007,17139
1792,1792,4121,2007-04-17 06:11:00,Jeeny,-5,2007,17134
1793,1793,4120,2007-04-17 06:16:00,Bolt Vanderhuge,17,2007,17151
1794,1794,4118,2007-04-17 06:21:00,Golbez,3,2007,17154
1795,1795,4119,2007-04-17 06:21:00,Swatjester,2,2007,17156
1796,1796,4117,2007-04-17 06:22:00,Swatjester,-13,2007,17143
1797,1800,4113,2007-04-17 06:24:00,Natwebb,211,2007,17354
1798,1799,4114,2007-04-17 06:24:00,Ryulong,-191,2007,17163
1799,1797,4116,2007-04-17 06:24:00,Ryulong,-2,2007,17161
1800,1798,4115,2007-04-17 06:24:00,Natwebb,191,2007,17352
1801,1801,4112,2007-04-17 06:25:00,Theonlysilentbob,73,2007,17425
1802,1802,4111,2007-04-17 06:26:00,Ryulong,-73,2007,17352
1803,1803,4110,2007-04-17 06:27:00,Lid,0,2007,17352
1804,1804,4109,2007-04-17 06:30:00,Lid,-211,2007,17141
1805,1805,4108,2007-04-17 06:31:00,Cmichael,9,2007,17150
1806,1806,4107,2007-04-17 06:32:00,Swatjester,-153,2007,16997
1807,1807,4106,2007-04-17 06:36:00,Halo,-14,2007,16983
1808,1808,4105,2007-04-17 06:39:00,Elonka,2,2007,16985
1809,1809,4104,2007-04-17 06:45:00,Yaddar,293,2007,17278
1810,1810,4103,2007-04-17 06:46:00,Sylvia.wei,4,2007,17282
1811,1811,4102,2007-04-17 06:47:00,Vaoverland,0,2007,17282
1812,1812,4101,2007-04-17 06:50:00,Yaddar,343,2007,17625
1813,1813,4100,2007-04-17 06:50:00,Yorkshiresky,474,2007,18099
1814,1814,4099,2007-04-17 06:51:00,Yaddar,-1,2007,18098
1815,1815,4098,2007-04-17 07:08:00,BorgQueen,-9,2007,18089
1816,1816,4097,2007-04-17 07:10:00,BorgQueen,18,2007,18107
1817,1817,4096,2007-04-17 07:12:00,BorgQueen,102,2007,18209
1818,1818,4095,2007-04-17 07:15:00,Kizor,-2,2007,18207
1819,1819,4094,2007-04-17 07:15:00,Kizor,8,2007,18215
1820,1820,4093,2007-04-17 07:15:00,MisterHand,-97,2007,18118
1821,1822,4091,2007-04-17 07:17:00,MisterHand,6,2007,18124
1822,1821,4092,2007-04-17 07:17:00,BorgQueen,2,2007,18126
1823,1823,4090,2007-04-17 07:18:00,BorgQueen,-2,2007,18124
1824,1824,4089,2007-04-17 07:30:00,Ixfd64,28,2007,18152
1825,1825,4088,2007-04-17 07:34:00,John9276,70,2007,18222
1826,1826,4085,2007-04-17 07:37:00,Mercenary2k,0,2007,18222
1827,1827,4086,2007-04-17 07:37:00,Wskitche,0,2007,18222
1828,1828,4087,2007-04-17 07:37:00,StayinAnon,-70,2007,18152
1829,1829,4084,2007-04-17 07:38:00,Wskitche,31,2007,18183
1830,1830,4083,2007-04-17 07:39:00,BlaiseFEgan,6,2007,18189
1831,1831,4082,2007-04-17 07:40:00,Atou~enwiki,360,2007,18549
1832,1832,4081,2007-04-17 07:42:00,RG2,-50,2007,18499
1833,1833,4080,2007-04-17 07:43:00,Kizor,-110,2007,18389
1834,1834,4079,2007-04-17 07:44:00,Wskitche,-59,2007,18330
1835,1836,4077,2007-04-17 07:46:00,MisterHand,9,2007,18339
1836,1835,4078,2007-04-17 07:46:00,Kizor,-28,2007,18311
1837,1837,4076,2007-04-17 07:52:00,Atou~enwiki,173,2007,18484
1838,1838,4075,2007-04-17 07:59:00,Vaoverland,28,2007,18512
1839,1839,4074,2007-04-17 08:00:00,Vaoverland,0,2007,18512
1840,1840,4073,2007-04-17 08:02:00,LafinJack,-5,2007,18507
1841,1841,4072,2007-04-17 08:07:00,Mercenary2k,57,2007,18564
1842,1842,4071,2007-04-17 08:08:00,Mercenary2k,51,2007,18615
1843,1843,4070,2007-04-17 08:08:00,LigerThai,131,2007,18746
1844,1844,4069,2007-04-17 08:12:00,Scriberius,33,2007,18779
1845,1845,4068,2007-04-17 08:13:00,John Stattic,-3,2007,18776
1846,1847,4066,2007-04-17 08:16:00,Branddobbe,-33,2007,18743
1847,1848,4065,2007-04-17 08:16:00,Mercenary2k,4,2007,18747
1848,1846,4067,2007-04-17 08:16:00,Atou~enwiki,241,2007,18988
1849,1849,4064,2007-04-17 08:19:00,Aaporter 87,0,2007,18988
1850,1850,4061,2007-04-17 08:20:00,Kschutt,21,2007,19009
1851,1851,4062,2007-04-17 08:20:00,Aaporter 87,16,2007,19025
1852,1852,4063,2007-04-17 08:20:00,Lisasmall,291,2007,19316
1853,1853,4060,2007-04-17 08:21:00,Penguinee,0,2007,19316
1854,1854,4059,2007-04-17 08:21:00,Kschutt,61,2007,19377
1855,1855,4058,2007-04-17 08:23:00,John Stattic,-3,2007,19374
1856,1857,4056,2007-04-17 08:25:00,Mercenary2k,1,2007,19375
1857,1856,4057,2007-04-17 08:25:00,Mercenary2k,294,2007,19669
1858,1858,4055,2007-04-17 08:27:00,Zib~enwiki,72,2007,19741
1859,1859,4054,2007-04-17 08:28:00,Zib~enwiki,-4,2007,19737
1860,1860,4053,2007-04-17 08:29:00,Tomasboij,1,2007,19738
1861,1861,4052,2007-04-17 08:29:00,Ctbolt,0,2007,19738
1862,1862,4051,2007-04-17 08:31:00,Mercenary2k,0,2007,19738
1863,1863,4050,2007-04-17 08:32:00,Mercenary2k,386,2007,20124
1864,1864,4049,2007-04-17 08:33:00,Kschutt,61,2007,20185
1865,1865,4048,2007-04-17 08:34:00,RR,-24,2007,20161
1866,1866,4047,2007-04-17 08:35:00,Kschutt,55,2007,20216
1867,1867,4046,2007-04-17 08:35:00,Tomasboij,1,2007,20217
1868,1868,4045,2007-04-17 08:36:00,Mercenary2k,162,2007,20379
1869,1869,4044,2007-04-17 08:37:00,Mishkan,41,2007,20420
1870,1870,4043,2007-04-17 08:38:00,Ctbolt,0,2007,20420
1871,1871,4042,2007-04-17 08:40:00,Penguinee,-141,2007,20279
1872,1872,4041,2007-04-17 08:40:00,Penguinee,82,2007,20361
1873,1873,4040,2007-04-17 08:41:00,Kschutt,93,2007,20454
1874,1874,4039,2007-04-17 08:42:00,Arsonal,-69,2007,20385
1875,1875,4038,2007-04-17 08:42:00,Penguinee,96,2007,20481
1876,1876,4037,2007-04-17 08:44:00,Mercenary2k,493,2007,20974
1877,1877,4036,2007-04-17 08:44:00,Penguinee,-263,2007,20711
1878,1878,4035,2007-04-17 08:45:00,Mercenary2k,-64,2007,20647
1879,1879,4034,2007-04-17 08:46:00,Penguinee,-140,2007,20507
1880,1880,4033,2007-04-17 08:47:00,Arsonal,85,2007,20592
1881,1883,4032,2007-04-17 08:48:00,Penguinee,-95,2007,20497
1882,1882,4030,2007-04-17 08:48:00,Ctbolt,-217,2007,20280
1883,1881,4031,2007-04-17 08:48:00,Penguinee,-2,2007,20278
1884,1884,4029,2007-04-17 08:49:00,Penguinee,1,2007,20279
1885,1885,4028,2007-04-17 08:50:00,Arsonal,6,2007,20285
1886,1886,4027,2007-04-17 08:51:00,Arsonal,-8,2007,20277
1887,1887,4026,2007-04-17 08:51:00,Arsonal,0,2007,20277
1888,1888,4025,2007-04-17 08:52:00,Penguinee,-58,2007,20219
1889,1889,4024,2007-04-17 08:52:00,Mercenary2k,350,2007,20569
1890,1890,4023,2007-04-17 08:53:00,Penguinee,-151,2007,20418
1891,1891,4022,2007-04-17 08:54:00,Mercenary2k,0,2007,20418
1892,1892,4021,2007-04-17 08:55:00,Mercenary2k,12,2007,20430
1893,1893,4020,2007-04-17 08:56:00,Kschutt,1,2007,20431
1894,1894,4019,2007-04-17 08:57:00,Arsonal,-4,2007,20427
1895,1895,4018,2007-04-17 08:59:00,Arsonal,-372,2007,20055
1896,1896,4017,2007-04-17 09:00:00,Kschutt,226,2007,20281
1897,1897,4016,2007-04-17 09:01:00,Penguinee,114,2007,20395
1898,1898,4015,2007-04-17 09:01:00,Penguinee,1,2007,20396
1899,1899,4012,2007-04-17 09:02:00,Golbez,115,2007,20511
1900,1900,4013,2007-04-17 09:02:00,Tomasboij,1,2007,20512
1901,1901,4014,2007-04-17 09:02:00,Penguinee,-195,2007,20317
1902,1902,4011,2007-04-17 09:03:00,Arsonal,-40,2007,20277
1903,1903,4010,2007-04-17 09:03:00,Mercenary2k,379,2007,20656
1904,1904,4009,2007-04-17 09:04:00,Mercenary2k,-40,2007,20616
1905,1906,4007,2007-04-17 09:05:00,Ixfd64,-24,2007,20592
1906,1905,4008,2007-04-17 09:05:00,Arsonal,-226,2007,20366
1907,1907,4006,2007-04-17 09:06:00,Ladeer,0,2007,20366
1908,1908,4005,2007-04-17 09:06:00,Arsonal,31,2007,20397
1909,1909,4004,2007-04-17 09:07:00,Ladeer,5,2007,20402
1910,1910,4003,2007-04-17 09:07:00,Scotthatton,63,2007,20465
1911,1911,4002,2007-04-17 09:08:00,Ladeer,0,2007,20465
1912,1912,4001,2007-04-17 09:10:00,Ladeer,4,2007,20469
1913,1913,4000,2007-04-17 09:12:00,Mercenary2k,-6,2007,20463
1914,1914,3999,2007-04-17 09:12:00,Arsonal,-69,2007,20394
1915,1915,3998,2007-04-17 09:12:00,Arsonal,-1,2007,20393
1916,1916,3997,2007-04-17 09:14:00,Arsonal,-40,2007,20353
1917,1917,3996,2007-04-17 09:15:00,Arsonal,-38,2007,20315
1918,1918,3995,2007-04-17 09:16:00,Tomasboij,-1,2007,20314
1919,1919,3994,2007-04-17 09:18:00,Mercenary2k,0,2007,20314
1920,1920,3991,2007-04-17 09:19:00,Mercenary2k,0,2007,20314
1921,1921,3992,2007-04-17 09:19:00,Tofilmfan,0,2007,20314
1922,1922,3990,2007-04-17 09:20:00,Mercenary2k,-96,2007,20218
1923,1923,3989,2007-04-17 09:20:00,Kizor,90,2007,20308
1924,1924,3988,2007-04-17 09:21:00,Mercenary2k,1,2007,20309
1925,1925,3987,2007-04-17 09:22:00,Kizor,-309,2007,20000
1926,1926,3986,2007-04-17 09:22:00,Arsonal,-413,2007,19587
1927,1927,3985,2007-04-17 09:23:00,Kizor,8,2007,19595
1928,1928,3984,2007-04-17 09:24:00,Nickybutt,4,2007,19599
1929,1929,3983,2007-04-17 09:26:00,Kizor,-4,2007,19595
1930,1930,3982,2007-04-17 09:26:00,W guice,-12,2007,19583
1931,1931,3981,2007-04-17 09:27:00,W guice,1,2007,19584
1932,1932,3978,2007-04-17 09:28:00,W guice,-1,2007,19583
1933,1933,3979,2007-04-17 09:28:00,W guice,1,2007,19584
1934,1934,3980,2007-04-17 09:28:00,Rjyanco,1,2007,19585
1935,1935,3977,2007-04-17 09:31:00,W guice,-30,2007,19555
1936,1936,3976,2007-04-17 09:31:00,The clever wiki editing man,97,2007,19652
1937,1937,3975,2007-04-17 09:32:00,Zib~enwiki,-97,2007,19555
1938,1938,3974,2007-04-17 09:32:00,Scotthatton,19,2007,19574
1939,1939,3973,2007-04-17 09:34:00,Arsonal,1,2007,19575
1940,1940,3972,2007-04-17 09:36:00,Kschutt,1,2007,19576
1941,1941,3971,2007-04-17 09:37:00,Arsonal,12,2007,19588
1942,1942,3970,2007-04-17 09:38:00,Arsonal,-13,2007,19575
1943,1943,3968,2007-04-17 09:45:00,Ctbolt,1,2007,19576
1944,1944,3967,2007-04-17 09:50:00,Kschutt,44,2007,19620
1945,1945,3966,2007-04-17 09:50:00,Abe Lincoln,20,2007,19640
1946,1946,3965,2007-04-17 09:51:00,MoRsE,308,2007,19948
1947,1947,3964,2007-04-17 09:54:00,Siliconov,-256,2007,19692
1948,1948,3963,2007-04-17 09:54:00,DeusMP,288,2007,19980
1949,1949,3962,2007-04-17 09:55:00,Mercenary2k,67,2007,20047
1950,1950,3961,2007-04-17 09:58:00,The Cosmonaut,-3,2007,20044
1951,1951,3960,2007-04-17 09:59:00,The Cosmonaut,2,2007,20046
1952,1952,3959,2007-04-17 10:02:00,Abe Lincoln,6,2007,20052
1953,1953,3958,2007-04-17 10:05:00,Rschafe,75,2007,20127
1954,1954,3957,2007-04-17 10:05:00,Rschafe,0,2007,20127
1955,1955,3956,2007-04-17 10:08:00,Mercenary2k,-2,2007,20125
1956,1956,3955,2007-04-17 10:08:00,Billtheking,-67,2007,20058
1957,1957,3954,2007-04-17 10:12:00,Mercenary2k,-1,2007,20057
1958,1958,3953,2007-04-17 10:12:00,Mercenary2k,44,2007,20101
1959,1959,3952,2007-04-17 10:13:00,Vaoverland,75,2007,20176
1960,1960,3951,2007-04-17 10:14:00,Dcandeto,-1,2007,20175
1961,1961,3950,2007-04-17 10:14:00,Vaoverland,7,2007,20182
1962,1962,3949,2007-04-17 10:18:00,Dcandeto,0,2007,20182
1963,1963,3948,2007-04-17 10:19:00,Zachary,60,2007,20242
1964,1964,3947,2007-04-17 10:21:00,Zib~enwiki,339,2007,20581
1965,1965,3946,2007-04-17 10:23:00,Dan East,24,2007,20605
1966,1966,3945,2007-04-17 10:24:00,Zib~enwiki,4,2007,20609
1967,1967,3943,2007-04-17 10:25:00,Vaoverland,1,2007,20610
1968,1968,3944,2007-04-17 10:25:00,Teggles,-66,2007,20544
1969,1969,3942,2007-04-17 10:26:00,Luckyj,9,2007,20553
1970,1970,3941,2007-04-17 10:26:00,Arsonal,-386,2007,20167
1971,1971,3940,2007-04-17 10:29:00,W guice,-1,2007,20166
1972,1972,3939,2007-04-17 10:30:00,W guice,-1,2007,20165
1973,1973,3938,2007-04-17 10:30:00,Astram,-20,2007,20145
1974,1974,3937,2007-04-17 10:32:00,EnviroGranny,31,2007,20176
1975,1975,3936,2007-04-17 10:33:00,W guice,-1,2007,20175
1976,1976,3935,2007-04-17 10:33:00,Supergeo,-67,2007,20108
1977,1977,3934,2007-04-17 10:34:00,EnviroGranny,1,2007,20109
1978,1978,3933,2007-04-17 10:36:00,IUJHJSDHE,23,2007,20132
1979,1979,3932,2007-04-17 10:38:00,Kenkoo1987,29,2007,20161
1980,1980,3930,2007-04-17 10:39:00,EnviroGranny,29,2007,20190
1981,1981,3931,2007-04-17 10:39:00,Dcandeto,-233,2007,19957
1982,1982,3929,2007-04-17 10:40:00,EnviroGranny,-14,2007,19943
1983,1984,3927,2007-04-17 10:41:00,Golbez,-16,2007,19927
1984,1985,3926,2007-04-17 10:41:00,Lucid,19,2007,19946
1985,1983,3928,2007-04-17 10:41:00,Ryanheitner,361,2007,20307
1986,1986,3925,2007-04-17 10:42:00,Rschafe,-66,2007,20241
1987,1987,3924,2007-04-17 10:42:00,Lucid,24,2007,20265
1988,1988,3923,2007-04-17 10:42:00,WWGB,-439,2007,19826
1989,1989,3922,2007-04-17 10:44:00,Lucid,25,2007,19851
1990,1990,3921,2007-04-17 10:47:00,Golbez,-149,2007,19702
1991,1991,3920,2007-04-17 10:48:00,Golbez,8,2007,19710
1992,1992,3919,2007-04-17 10:49:00,Golbez,-2,2007,19708
1993,1993,3918,2007-04-17 10:49:00,WWGB,5,2007,19713
1994,1995,3916,2007-04-17 10:50:00,Chnv,-113,2007,19600
1995,1994,3917,2007-04-17 10:50:00,Golbez,-60,2007,19540
1996,1996,3915,2007-04-17 10:50:00,Golbez,7,2007,19547
1997,1997,3914,2007-04-17 10:51:00,WWGB,-71,2007,19476
1998,1998,3913,2007-04-17 10:56:00,Dan East,21,2007,19497
1999,1999,3912,2007-04-17 10:56:00,Irdepesca572,40,2007,19537
2000,2000,3911,2007-04-17 10:58:00,Tone,30,2007,19567
2001,2001,3910,2007-04-17 11:01:00,Kizor,285,2007,19852
2002,2002,3909,2007-04-17 11:02:00,Dan East,153,2007,20005
2003,2003,3908,2007-04-17 11:02:00,Kizor,-10,2007,19995
2004,2004,3906,2007-04-17 11:04:00,Golbez,210,2007,20205
2005,2005,3907,2007-04-17 11:04:00,Kizor,-2,2007,20203
2006,2006,3905,2007-04-17 11:05:00,Muntuwandi,-2,2007,20201
2007,2007,3904,2007-04-17 11:05:00,Dcandeto,36,2007,20237
2008,2009,3902,2007-04-17 11:06:00,Kizor,-65,2007,20172
2009,2008,3903,2007-04-17 11:06:00,Kizor,-27,2007,20145
2010,2010,3901,2007-04-17 11:07:00,Muntuwandi,10,2007,20155
2011,2011,3900,2007-04-17 11:09:00,Karrmann,46,2007,20201
2012,2012,3899,2007-04-17 11:10:00,Kizor,280,2007,20481
2013,2013,3898,2007-04-17 11:10:00,Kizor,9,2007,20490
2014,2014,3897,2007-04-17 11:11:00,Skarioffszky,4,2007,20494
2015,2015,3894,2007-04-17 11:14:00,Kizor,-1,2007,20493
2016,2016,3896,2007-04-17 11:14:00,Badseed,-69,2007,20424
2017,2017,3895,2007-04-17 11:14:00,Dan East,113,2007,20537
2018,2018,3893,2007-04-17 11:15:00,Golbez,-55,2007,20482
2019,2021,3889,2007-04-17 11:16:00,Arsonal,4,2007,20486
2020,2022,3892,2007-04-17 11:16:00,Arsonal,6,2007,20492
2021,2020,3890,2007-04-17 11:16:00,Dan East,-1,2007,20491
2022,2019,3891,2007-04-17 11:16:00,Logophile,35,2007,20526
2023,2023,3888,2007-04-17 11:17:00,Arsonal,-2,2007,20524
2024,2024,3887,2007-04-17 11:18:00,Scifiintel,-3,2007,20521
2025,2025,3886,2007-04-17 11:19:00,OneNight,46,2007,20567
2026,2026,3885,2007-04-17 11:21:00,Scifiintel,-2,2007,20565
2027,2027,3884,2007-04-17 11:21:00,Golbez,-46,2007,20519
2028,2028,3883,2007-04-17 11:26:00,WWGB,24,2007,20543
2029,2029,3882,2007-04-17 11:27:00,John Stattic,-44,2007,20499
2030,2030,3881,2007-04-17 11:28:00,Dan East,106,2007,20605
2031,2031,3880,2007-04-17 11:30:00,GdB,46,2007,20651
2032,2032,3879,2007-04-17 11:33:00,Karaokeron,1,2007,20652
2033,2033,3878,2007-04-17 11:38:00,WWGB,-31,2007,20621
2034,2034,3877,2007-04-17 11:43:00,Dan East,0,2007,20621
2035,2035,3876,2007-04-17 11:45:00,Dan East,2,2007,20623
2036,2036,3875,2007-04-17 11:46:00,Golbez,22,2007,20645
2037,2037,3874,2007-04-17 11:48:00,Scheibenzahl,-9,2007,20636
2038,2038,3873,2007-04-17 11:50:00,Scheibenzahl,9,2007,20645
2039,2039,3872,2007-04-17 11:50:00,AEMoreira042281,-241,2007,20404
2040,2040,3871,2007-04-17 11:51:00,AEMoreira042281,30,2007,20434
2041,2041,3870,2007-04-17 11:51:00,AEMoreira042281,0,2007,20434
2042,2042,3869,2007-04-17 11:52:00,Varxx,20,2007,20454
2043,2044,3867,2007-04-17 11:53:00,AEMoreira042281,127,2007,20581
2044,2043,3868,2007-04-17 11:53:00,Varxx,1,2007,20582
2045,2045,3866,2007-04-17 11:54:00,AEMoreira042281,24,2007,20606
2046,2046,3865,2007-04-17 11:54:00,W guice,4,2007,20610
2047,2047,3864,2007-04-17 11:55:00,W guice,-30,2007,20580
2048,2048,3863,2007-04-17 11:56:00,Arsonal,145,2007,20725
2049,2049,3862,2007-04-17 11:56:00,A bit iffy,0,2007,20725
2050,2050,3861,2007-04-17 11:56:00,Arsonal,0,2007,20725
2051,2051,3860,2007-04-17 12:00:00,Imacdo,0,2007,20725
2052,2052,3859,2007-04-17 12:03:00,ElKevbo,-9,2007,20716
2053,2053,3858,2007-04-17 12:04:00,Varxx,114,2007,20830
2054,2054,3857,2007-04-17 12:05:00,Varxx,-179,2007,20651
2055,2056,3855,2007-04-17 12:06:00,W guice,106,2007,20757
2056,2055,3856,2007-04-17 12:06:00,Varxx,90,2007,20847
2057,2057,3854,2007-04-17 12:07:00,Editor Emeritus,227,2007,21074
2058,2058,3853,2007-04-17 12:08:00,W guice,0,2007,21074
2059,2059,3852,2007-04-17 12:09:00,Alxsml,0,2007,21074
2060,2060,3851,2007-04-17 12:09:00,Editor Emeritus,-1,2007,21073
2061,2061,3848,2007-04-17 12:11:00,Malevolentjebus,-30,2007,21043
2062,2062,3849,2007-04-17 12:11:00,Editor Emeritus,10,2007,21053
2063,2063,3850,2007-04-17 12:11:00,Cinemaniac86,0,2007,21053
2064,2065,3846,2007-04-17 12:12:00,StuffOfInterest,82,2007,21135
2065,2064,3847,2007-04-17 12:12:00,Editor Emeritus,0,2007,21135
2066,2066,3845,2007-04-17 12:13:00,W guice,0,2007,21135
2067,2067,3844,2007-04-17 12:17:00,Golbez,27,2007,21162
2068,2068,3843,2007-04-17 12:18:00,Golbez,-27,2007,21135
2069,2069,3842,2007-04-17 12:22:00,Cinemaniac86,145,2007,21280
2070,2070,3841,2007-04-17 12:25:00,Alibrarian,126,2007,21406
2071,2071,3840,2007-04-17 12:26:00,Dan East,199,2007,21605
2072,2072,3839,2007-04-17 12:27:00,Cinemaniac86,34,2007,21639
2073,2073,3838,2007-04-17 12:27:00,Threeafterthree,-126,2007,21513
2074,2074,3837,2007-04-17 12:29:00,Dan East,133,2007,21646
2075,2075,3836,2007-04-17 12:30:00,W guice,-31,2007,21615
2076,2076,3835,2007-04-17 12:31:00,Scifiintel,-82,2007,21533
2077,2077,3834,2007-04-17 12:31:00,W guice,82,2007,21615
2078,2078,3833,2007-04-17 12:33:00,Cinemaniac86,3,2007,21618
2079,2080,3831,2007-04-17 12:34:00,SNIyer12,167,2007,21785
2080,2079,3832,2007-04-17 12:34:00,WWGB,-148,2007,21637
2081,2081,3830,2007-04-17 12:35:00,Retired username,0,2007,21637
2082,2082,3829,2007-04-17 12:36:00,W guice,-167,2007,21470
2083,2083,3828,2007-04-17 12:36:00,Nunoire,4,2007,21474
2084,2084,3827,2007-04-17 12:37:00,Starks,16,2007,21490
2085,2085,3826,2007-04-17 12:37:00,Retired username,-49,2007,21441
2086,2086,3825,2007-04-17 12:38:00,Retired username,-4,2007,21437
2087,2087,3824,2007-04-17 12:38:00,Mmustafa~enwiki,44,2007,21481
2088,2093,3821,2007-04-17 12:39:00,W guice,-16,2007,21465
2089,2092,3823,2007-04-17 12:39:00,SNIyer12,-33,2007,21432
2090,2091,3822,2007-04-17 12:39:00,Abe Lincoln,29,2007,21461
2091,2090,3820,2007-04-17 12:39:00,Lucid,-291,2007,21170
2092,2089,3819,2007-04-17 12:39:00,Pullarius1,-3,2007,21167
2093,2088,3818,2007-04-17 12:39:00,SNIyer12,-29,2007,21138
2094,2094,3817,2007-04-17 12:41:00,SNIyer12,193,2007,21331
2095,2095,3816,2007-04-17 12:41:00,Golbez,-35,2007,21296
2096,2096,3815,2007-04-17 12:44:00,W guice,-193,2007,21103
2097,2097,3814,2007-04-17 12:45:00,Bueller 007,-8,2007,21095
2098,2098,3813,2007-04-17 12:46:00,Golbez,4,2007,21099
2099,2099,3812,2007-04-17 12:48:00,Fowler&fowler,4,2007,21103
2100,2100,3811,2007-04-17 12:48:00,LetTheSunshineIn,62,2007,21165
2101,2102,3809,2007-04-17 12:49:00,Mikethegreen,-1,2007,21164
2102,2101,3810,2007-04-17 12:49:00,Mikethegreen,451,2007,21615
2103,2103,3808,2007-04-17 12:51:00,Mikethegreen,35,2007,21650
2104,2104,3807,2007-04-17 12:52:00,Arsonal,431,2007,22081
2105,2105,3806,2007-04-17 12:56:00,W guice,-4,2007,22077
2106,2106,3805,2007-04-17 12:57:00,Cinemaniac86,4,2007,22081
2107,2107,3804,2007-04-17 12:57:00,StuffOfInterest,82,2007,22163
2108,2108,3803,2007-04-17 12:57:00,W guice,-66,2007,22097
2109,2109,3802,2007-04-17 12:58:00,W guice,4,2007,22101
2110,2110,3801,2007-04-17 12:58:00,Golbez,-82,2007,22019
2111,2111,3800,2007-04-17 12:59:00,W guice,0,2007,22019
2112,2113,3799,2007-04-17 13:00:00,W guice,8,2007,22027
2113,2112,3798,2007-04-17 13:00:00,W guice,4,2007,22031
2114,2114,3797,2007-04-17 13:01:00,Irdepesca572,9,2007,22040
2115,2115,3795,2007-04-17 13:02:00,Kevinp2,0,2007,22040
2116,2116,3796,2007-04-17 13:02:00,Ellipsis,0,2007,22040
2117,2117,3793,2007-04-17 13:03:00,Gazab1,0,2007,22040
2118,2118,3794,2007-04-17 13:03:00,W guice,82,2007,22122
2119,2119,3792,2007-04-17 13:04:00,Golbez,0,2007,22122
2120,2120,3791,2007-04-17 13:04:00,Gazab1,0,2007,22122
2121,2121,3790,2007-04-17 13:04:00,Golbez,22,2007,22144
2122,2123,3788,2007-04-17 13:05:00,Ike9898,-4,2007,22140
2123,2124,3787,2007-04-17 13:05:00,Violetion,15,2007,22155
2124,2122,3789,2007-04-17 13:05:00,Ike9898,-3,2007,22152
2125,2125,3786,2007-04-17 13:08:00,THF,77,2007,22229
2126,2126,3785,2007-04-17 13:09:00,Jauerback,4,2007,22233
2127,2127,3784,2007-04-17 13:11:00,Raineybt,0,2007,22233
2128,2128,3783,2007-04-17 13:11:00,Moncrief,-13,2007,22220
2129,2129,3782,2007-04-17 13:12:00,Moncrief,3,2007,22223
2130,2130,3781,2007-04-17 13:13:00,Moncrief,2,2007,22225
2131,2131,3780,2007-04-17 13:14:00,Irdepesca572,27,2007,22252
2132,2133,3778,2007-04-17 13:16:00,THF,245,2007,22497
2133,2132,3779,2007-04-17 13:16:00,Daysleeper47,0,2007,22497
2134,2134,3777,2007-04-17 13:16:00,Renamed user Sloane,8,2007,22505
2135,2136,3776,2007-04-17 13:17:00,Moncrief,81,2007,22586
2136,2135,3775,2007-04-17 13:17:00,Kevinp2,0,2007,22586
2137,2137,3774,2007-04-17 13:18:00,Golbez,0,2007,22586
2138,2138,3773,2007-04-17 13:18:00,MoRsE,6,2007,22592
2139,2139,3772,2007-04-17 13:20:00,Liulab,0,2007,22592
2140,2140,3771,2007-04-17 13:21:00,Retired username,188,2007,22780
2141,2141,3770,2007-04-17 13:21:00,Golbez,-187,2007,22593
2142,2142,3769,2007-04-17 13:22:00,Golbez,187,2007,22780
2143,2143,3768,2007-04-17 13:22:00,Ronnotel,-145,2007,22635
2144,2144,3767,2007-04-17 13:23:00,Ronnotel,83,2007,22718
2145,2145,3766,2007-04-17 13:23:00,Elliskev,64,2007,22782
2146,2147,3765,2007-04-17 13:25:00,Macraw83,-269,2007,22513
2147,2148,3764,2007-04-17 13:25:00,THF,-26,2007,22487
2148,2146,3763,2007-04-17 13:25:00,Ronnotel,80,2007,22567
2149,2149,3762,2007-04-17 13:26:00,Ronnotel,2,2007,22569
2150,2150,3761,2007-04-17 13:27:00,Narkstraws,0,2007,22569
2151,2151,3760,2007-04-17 13:28:00,THF,172,2007,22741
2152,2152,3759,2007-04-17 13:29:00,Coemgenus,162,2007,22903
2153,2153,3758,2007-04-17 13:29:00,Irdepesca572,12,2007,22915
2154,2154,3757,2007-04-17 13:30:00,Ronnotel,32,2007,22947
2155,2155,3756,2007-04-17 13:30:00,Liulab,268,2007,23215
2156,2156,3755,2007-04-17 13:30:00,Ronnotel,1,2007,23216
2157,2157,3754,2007-04-17 13:31:00,Coemgenus,16,2007,23232
2158,2160,3752,2007-04-17 13:32:00,Paul Norfolk Dumpling,0,2007,23232
2159,2158,3751,2007-04-17 13:32:00,Arsonal,10,2007,23242
2160,2159,3753,2007-04-17 13:32:00,Violetion,129,2007,23371
2161,2161,3749,2007-04-17 13:33:00,Jauerback,6,2007,23377
2162,2162,3750,2007-04-17 13:33:00,Irdepesca572,-188,2007,23189
2163,2163,3747,2007-04-17 13:34:00,Vanished User 0001,-1,2007,23188
2164,2164,3746,2007-04-17 13:34:00,Coemgenus,-143,2007,23045
2165,2165,3745,2007-04-17 13:34:00,Jambalaya~enwiki,0,2007,23045
2166,2166,3748,2007-04-17 13:34:00,Cdman882,246,2007,23291
2167,2169,3742,2007-04-17 13:35:00,Matthew0820,54,2007,23345
2168,2170,3741,2007-04-17 13:35:00,Violetion,18,2007,23363
2169,2167,3744,2007-04-17 13:35:00,Irdepesca572,0,2007,23363
2170,2168,3743,2007-04-17 13:35:00,Ronnotel,0,2007,23363
2171,2171,3739,2007-04-17 13:36:00,Violetion,-2,2007,23361
2172,2172,3740,2007-04-17 13:36:00,Coemgenus,-245,2007,23116
2173,2173,3738,2007-04-17 13:37:00,とある白い猫,-238,2007,22878
2174,2174,3737,2007-04-17 13:37:00,Dposse,-117,2007,22761
2175,2175,3736,2007-04-17 13:37:00,RCSIRCSIRCSI,-300,2007,22461
2176,2176,3735,2007-04-17 13:38:00,Cdman882,14,2007,22475
2177,2177,3734,2007-04-17 13:38:00,Macraw83,0,2007,22475
2178,2178,3733,2007-04-17 13:40:00,Macraw83,0,2007,22475
2179,2179,3732,2007-04-17 13:40:00,Cdman882,1,2007,22476
2180,2180,3731,2007-04-17 13:41:00,Violetion,-253,2007,22223
2181,2182,3730,2007-04-17 13:42:00,Dposse,-194,2007,22029
2182,2181,3729,2007-04-17 13:42:00,Violetion,51,2007,22080
2183,2183,3726,2007-04-17 13:43:00,Violetion,14,2007,22094
2184,2184,3728,2007-04-17 13:43:00,Macraw83,0,2007,22094
2185,2185,3727,2007-04-17 13:43:00,IvanLanin,33,2007,22127
2186,2186,3725,2007-04-17 13:44:00,Emerrill,6,2007,22133
2187,2187,3724,2007-04-17 13:44:00,Irdepesca572,-3,2007,22130
2188,2188,3723,2007-04-17 13:45:00,Golbez,-54,2007,22076
2189,2190,3721,2007-04-17 13:46:00,Jonathanleblang,97,2007,22173
2190,2191,3720,2007-04-17 13:46:00,Golbez,59,2007,22232
2191,2189,3722,2007-04-17 13:46:00,Macraw83,16,2007,22248
2192,2192,3717,2007-04-17 13:47:00,MoRsE,0,2007,22248
2193,2193,3718,2007-04-17 13:47:00,Thomasmallen,0,2007,22248
2194,2194,3719,2007-04-17 13:47:00,Bellhalla,8,2007,22256
2195,2195,3716,2007-04-17 13:48:00,THF,-3,2007,22253
2196,2196,3715,2007-04-17 13:49:00,LuckyandLucky,86,2007,22339
2197,2197,3714,2007-04-17 13:49:00,Hellcat fighter,-6,2007,22333
2198,2198,3713,2007-04-17 13:53:00,LuckyandLucky,39,2007,22372
2199,2199,3712,2007-04-17 13:55:00,Thomasmallen,0,2007,22372
2200,2200,3711,2007-04-17 13:56:00,Barney54,9,2007,22381
2201,2201,3710,2007-04-17 13:57:00,MoRsE,-2,2007,22379
2202,2202,3709,2007-04-17 13:57:00,Ronnotel,-196,2007,22183
2203,2203,3708,2007-04-17 13:58:00,Steamclock,-125,2007,22058
2204,2206,3706,2007-04-17 13:59:00,Ronnotel,-7,2007,22051
2205,2205,3707,2007-04-17 13:59:00,Golbez,125,2007,22176
2206,2204,3705,2007-04-17 13:59:00,Wordbuilder,-6,2007,22170
2207,2207,3703,2007-04-17 14:00:00,LuckyandLucky,0,2007,22170
2208,2208,3704,2007-04-17 14:00:00,Ronnotel,-419,2007,21751
2209,2209,3702,2007-04-17 14:01:00,Stebbins,11,2007,21762
2210,2210,3701,2007-04-17 14:01:00,Barney54,1,2007,21763
2211,2211,3700,2007-04-17 14:01:00,THF,1,2007,21764
2212,2212,3699,2007-04-17 14:01:00,Kuzwa,105,2007,21869
2213,2213,3698,2007-04-17 14:01:00,Flyguy649,175,2007,22044
2214,2215,3696,2007-04-17 14:02:00,Noclip,-20,2007,22024
2215,2216,3695,2007-04-17 14:02:00,Zehly,18,2007,22042
2216,2214,3697,2007-04-17 14:02:00,Golbez,-105,2007,21937
2217,2217,3692,2007-04-17 14:03:00,Jauerback,8,2007,21945
2218,2218,3693,2007-04-17 14:03:00,Cobun,1,2007,21946
2219,2219,3694,2007-04-17 14:03:00,Flyguy649,175,2007,22121
2220,2220,3691,2007-04-17 14:04:00,Wordbuilder,70,2007,22191
2221,2221,3690,2007-04-17 14:05:00,Jeeny,2,2007,22193
2222,2222,3689,2007-04-17 14:05:00,Daysleeper47,-1,2007,22192
2223,2223,3688,2007-04-17 14:05:00,Fran Rogers,4,2007,22196
2224,2224,3687,2007-04-17 14:05:00,Jeeny,-5,2007,22191
2225,2226,3685,2007-04-17 14:06:00,Ronnotel,10,2007,22201
2226,2225,3686,2007-04-17 14:06:00,THF,12,2007,22213
2227,2227,3684,2007-04-17 14:08:00,Leahym,-11,2007,22202
2228,2228,3683,2007-04-17 14:10:00,Jauerback,11,2007,22213
2229,2229,3682,2007-04-17 14:11:00,Arsonal,232,2007,22445
2230,2230,3681,2007-04-17 14:12:00,Scientz,-4,2007,22441
2231,2231,3680,2007-04-17 14:13:00,The Cosmonaut,0,2007,22441
2232,2232,3679,2007-04-17 14:13:00,Sgt Pinback,11,2007,22452
2233,2233,3678,2007-04-17 14:14:00,The Cosmonaut,37,2007,22489
2234,2234,3677,2007-04-17 14:16:00,Arsonal,52,2007,22541
2235,2235,3676,2007-04-17 14:16:00,Arsonal,-8,2007,22533
2236,2236,3675,2007-04-17 14:17:00,De Administrando Imperio,-103,2007,22430
2237,2237,3674,2007-04-17 14:17:00,Merbabu,-1,2007,22429
2238,2238,3673,2007-04-17 14:17:00,Ike9898,9,2007,22438
2239,2242,3671,2007-04-17 14:18:00,HokieRNB,79,2007,22517
2240,2241,3672,2007-04-17 14:18:00,.:Alex:.,6,2007,22523
2241,2239,3670,2007-04-17 14:18:00,Wealthy,28,2007,22551
2242,2240,3669,2007-04-17 14:18:00,Ike9898,-10,2007,22541
2243,2243,3668,2007-04-17 14:19:00,Ike9898,-6,2007,22535
2244,2244,3667,2007-04-17 14:19:00,Ud138guard,44,2007,22579
2245,2245,3666,2007-04-17 14:19:00,Ud138guard,-1,2007,22578
2246,2246,3665,2007-04-17 14:21:00,Mckraz,-41,2007,22537
2247,2247,3664,2007-04-17 14:21:00,Ike9898,-5,2007,22532
2248,2248,3663,2007-04-17 14:22:00,MoRsE,-2,2007,22530
2249,2249,3662,2007-04-17 14:23:00,Rdfox 76,-79,2007,22451
2250,2251,3660,2007-04-17 14:24:00,DeeKay42,0,2007,22451
2251,2250,3661,2007-04-17 14:24:00,Guthrie,7,2007,22458
2252,2252,3657,2007-04-17 14:25:00,LuckyandLucky,125,2007,22583
2253,2253,3655,2007-04-17 14:25:00,Orchid121480,4,2007,22587
2254,2254,3656,2007-04-17 14:25:00,Golbez,0,2007,22587
2255,2255,3658,2007-04-17 14:25:00,Stebbins,-46,2007,22541
2256,2256,3659,2007-04-17 14:25:00,MeanStreets,8,2007,22549
2257,2257,3654,2007-04-17 14:26:00,Nordberg3313,25,2007,22574
2258,2258,3653,2007-04-17 14:26:00,PaddyBriggs,-10,2007,22564
2259,2259,3652,2007-04-17 14:27:00,Ronnotel,-21,2007,22543
2260,2265,3651,2007-04-17 14:28:00,Steamclock,-125,2007,22418
2261,2264,3646,2007-04-17 14:28:00,Coemgenus,1,2007,22419
2262,2263,3647,2007-04-17 14:28:00,RahadyanS,12,2007,22431
2263,2262,3648,2007-04-17 14:28:00,SmackBot,3,2007,22434
2264,2261,3649,2007-04-17 14:28:00,Stebbins,-9,2007,22425
2265,2260,3650,2007-04-17 14:28:00,John Stattic,-1,2007,22424
2266,2266,3645,2007-04-17 14:29:00,John Stattic,5,2007,22429
2267,2267,3644,2007-04-17 14:29:00,Coemgenus,2,2007,22431
2268,2268,3643,2007-04-17 14:30:00,Ball&Chain,1,2007,22432
2269,2269,3641,2007-04-17 14:31:00,Chid12,466,2007,22898
2270,2270,3642,2007-04-17 14:31:00,Retired username,368,2007,23266
2271,2271,3640,2007-04-17 14:32:00,John Stattic,4,2007,23270
2272,2274,3637,2007-04-17 14:33:00,Stebbins,0,2007,23270
2273,2273,3638,2007-04-17 14:33:00,MoRsE,341,2007,23611
2274,2272,3639,2007-04-17 14:33:00,Retired username,35,2007,23646
2275,2275,3636,2007-04-17 14:34:00,Zooomabooma,106,2007,23752
2276,2276,3635,2007-04-17 14:34:00,PalawanOz,35,2007,23787
2277,2277,3634,2007-04-17 14:34:00,Semiautomata,1,2007,23788
2278,2278,3633,2007-04-17 14:34:00,MoRsE,6,2007,23794
2279,2279,3631,2007-04-17 14:35:00,Golbez,-106,2007,23688
2280,2280,3632,2007-04-17 14:35:00,MoRsE,13,2007,23701
2281,2281,3628,2007-04-17 14:36:00,Krafty kaf,-3,2007,23698
2282,2282,3630,2007-04-17 14:36:00,Mista'B,0,2007,23698
2283,2283,3629,2007-04-17 14:36:00,Alphachimp,0,2007,23698
2284,2285,3626,2007-04-17 14:37:00,Krafty kaf,1,2007,23699
2285,2284,3627,2007-04-17 14:37:00,Zooomabooma,-19,2007,23680
2286,2286,3625,2007-04-17 14:38:00,Golbez,19,2007,23699
2287,2287,3624,2007-04-17 14:43:00,Namiie,26,2007,23725
2288,2288,3623,2007-04-17 14:43:00,Namiie,-1,2007,23724
2289,2289,3622,2007-04-17 14:44:00,Tanveerislam,4,2007,23728
2290,2290,3621,2007-04-17 14:44:00,Czj,4,2007,23732
2291,2291,3620,2007-04-17 14:45:00,Irdepesca572,44,2007,23776
2292,2292,3618,2007-04-17 14:46:00,Procule,39,2007,23815
2293,2293,3619,2007-04-17 14:46:00,Czj,0,2007,23815
2294,2294,3617,2007-04-17 14:47:00,Golbez,-39,2007,23776
2295,2296,3615,2007-04-17 14:48:00,Nil Einne,19,2007,23795
2296,2295,3616,2007-04-17 14:48:00,Theodork,29,2007,23824
2297,2297,3614,2007-04-17 14:49:00,Mrjinx,68,2007,23892
2298,2298,3613,2007-04-17 14:49:00,MoRsE,152,2007,24044
2299,2299,3612,2007-04-17 14:49:00,Azukimonaka,37,2007,24081
2300,2300,3611,2007-04-17 14:52:00,Procule,44,2007,24125
2301,2301,3610,2007-04-17 14:53:00,Crownjewel82,-7,2007,24118
2302,2302,3608,2007-04-17 14:55:00,ElKevbo,-52,2007,24066
2303,2303,3609,2007-04-17 14:55:00,Golbez,8,2007,24074
2304,2304,3606,2007-04-17 14:57:00,ElKevbo,-90,2007,23984
2305,2305,3607,2007-04-17 14:57:00,Thermos14,43,2007,24027
2306,2308,3605,2007-04-17 14:58:00,Thermos14,1,2007,24028
2307,2306,3604,2007-04-17 14:58:00,Mytwocents,23,2007,24051
2308,2307,3603,2007-04-17 14:58:00,Npatwari,491,2007,24542
2309,2309,3602,2007-04-17 15:00:00,Fran Rogers,134,2007,24676
2310,2310,3601,2007-04-17 15:00:00,Npatwari,4,2007,24680
2311,2311,3600,2007-04-17 15:02:00,Kizor,5,2007,24685
2312,2312,3599,2007-04-17 15:03:00,Fran Rogers,121,2007,24806
2313,2313,3598,2007-04-17 15:04:00,SlimVirgin,216,2007,25022
2314,2315,3597,2007-04-17 15:05:00,Kizor,179,2007,25201
2315,2314,3595,2007-04-17 15:05:00,BlackbeltMage,2,2007,25203
2316,2316,3596,2007-04-17 15:05:00,Doc glasgow,0,2007,25203
2317,2318,3593,2007-04-17 15:06:00,Azukimonaka,30,2007,25233
2318,2317,3594,2007-04-17 15:06:00,Npatwari,62,2007,25295
2319,2319,3592,2007-04-17 15:08:00,Friday,-4,2007,25291
2320,2320,3591,2007-04-17 15:09:00,Ryuch,291,2007,25582
2321,2321,3590,2007-04-17 15:10:00,Ryuch,1,2007,25583
2322,2322,3589,2007-04-17 15:11:00,66.255.105.3,0,2007,25583
2323,2323,3588,2007-04-17 15:11:00,Edison,-216,2007,25367
2324,2324,3587,2007-04-17 15:11:00,StuffOfInterest,-16,2007,25351
2325,2325,3586,2007-04-17 15:12:00,68.227.193.221,0,2007,25351
2326,2326,3584,2007-04-17 15:14:00,NJA,0,2007,25351
2327,2327,3585,2007-04-17 15:14:00,Rxnd,-8,2007,25343
2328,2328,3583,2007-04-17 15:15:00,Golbez,0,2007,25343
2329,2330,3580,2007-04-17 15:16:00,Yokes14,4,2007,25347
2330,2329,3582,2007-04-17 15:16:00,Slinky317,0,2007,25347
2331,2331,3579,2007-04-17 15:17:00,72.85.195.135,9,2007,25356
2332,2332,3578,2007-04-17 15:17:00,Titanium Dragon,0,2007,25356
2333,2333,3577,2007-04-17 15:17:00,Golbez,-9,2007,25347
2334,2334,3576,2007-04-17 15:17:00,Merodoc,-4,2007,25343
2335,2335,3572,2007-04-17 15:18:00,The Fat Man Who Never Came Back,-4,2007,25339
2336,2336,3573,2007-04-17 15:18:00,Thehoagster07,31,2007,25370
2337,2337,3575,2007-04-17 15:18:00,Rufus843,-35,2007,25335
2338,2338,3574,2007-04-17 15:18:00,Bueller 007,22,2007,25357
2339,2340,3570,2007-04-17 15:19:00,Mytwocents,40,2007,25397
2340,2339,3571,2007-04-17 15:19:00,NJA,0,2007,25397
2341,2342,3568,2007-04-17 15:22:00,Plattopus,-1,2007,25396
2342,2341,3569,2007-04-17 15:22:00,Temporarily Insane,18,2007,25414
2343,2343,3567,2007-04-17 15:23:00,Golbez,-56,2007,25358
2344,2344,3566,2007-04-17 15:23:00,Kaustuv,-7,2007,25351
2345,2345,3565,2007-04-17 15:23:00,Jossi,-81,2007,25270
2346,2346,3564,2007-04-17 15:25:00,Sirex98,0,2007,25270
2347,2347,3561,2007-04-17 15:26:00,Zooomabooma,14,2007,25284
2348,2348,3563,2007-04-17 15:26:00,Jimbobk,1,2007,25285
2349,2349,3562,2007-04-17 15:26:00,Daysleeper47,-16,2007,25269
2350,2350,3560,2007-04-17 15:27:00,Golbez,-1,2007,25268
2351,2351,3559,2007-04-17 15:28:00,Zooomabooma,81,2007,25349
2352,2352,3558,2007-04-17 15:28:00,207.216.14.212,-30,2007,25319
2353,2353,3557,2007-04-17 15:29:00,Baccyak4H,-1,2007,25318
2354,2357,3553,2007-04-17 15:30:00,Abe Lincoln,3,2007,25321
2355,2356,3554,2007-04-17 15:30:00,72.85.195.135,6,2007,25327
2356,2354,3556,2007-04-17 15:30:00,72.24.227.120,163,2007,25490
2357,2355,3555,2007-04-17 15:30:00,Golbez,-81,2007,25409
2358,2358,3552,2007-04-17 15:32:00,136.145.83.150,23,2007,25432
2359,2359,3551,2007-04-17 15:33:00,64.236.128.27,67,2007,25499
2360,2360,3550,2007-04-17 15:33:00,220.237.187.40,4,2007,25503
2361,2361,3549,2007-04-17 15:34:00,220.237.187.40,-4,2007,25499
2362,2362,3548,2007-04-17 15:34:00,ElKevbo,-21,2007,25478
2363,2363,3547,2007-04-17 15:34:00,Mcwiggin,144,2007,25622
2364,2367,3543,2007-04-17 15:36:00,Mcwiggin,117,2007,25739
2365,2366,3544,2007-04-17 15:36:00,Mytwocents,38,2007,25777
2366,2364,3546,2007-04-17 15:36:00,Dale Arnett,37,2007,25814
2367,2365,3545,2007-04-17 15:36:00,68.33.59.68,22,2007,25836
2368,2368,3540,2007-04-17 15:37:00,70.59.8.209,1,2007,25837
2369,2369,3539,2007-04-17 15:37:00,Kaustuv,136,2007,25973
2370,2370,3542,2007-04-17 15:37:00,70.59.8.209,16,2007,25989
2371,2371,3541,2007-04-17 15:37:00,Kmsiever,0,2007,25989
2372,2372,3538,2007-04-17 15:38:00,SlimVirgin,-35,2007,25954
2373,2373,3537,2007-04-17 15:38:00,ElKevbo,4,2007,25958
2374,2374,3536,2007-04-17 15:38:00,AEMoreira042281,-26,2007,25932
2375,2375,3535,2007-04-17 15:38:00,ElKevbo,-41,2007,25891
2376,2376,3534,2007-04-17 15:39:00,137.22.118.189,-8,2007,25883
2377,2377,3533,2007-04-17 15:39:00,The Cosmonaut,0,2007,25883
2378,2378,3532,2007-04-17 15:40:00,SlimVirgin,0,2007,25883
2379,2379,3531,2007-04-17 15:40:00,ElKevbo,-59,2007,25824
2380,2380,3528,2007-04-17 15:41:00,Muntuwandi,279,2007,26103
2381,2381,3530,2007-04-17 15:41:00,165.123.144.159,-93,2007,26010
2382,2382,3529,2007-04-17 15:41:00,Kaustuv,9,2007,26019
2383,2384,3526,2007-04-17 15:42:00,Natalie Erin,-2,2007,26017
2384,2383,3527,2007-04-17 15:42:00,66.50.247.171,33,2007,26050
2385,2385,3525,2007-04-17 15:43:00,72.85.195.135,16,2007,26066
2386,2389,3521,2007-04-17 15:44:00,Natalie Erin,0,2007,26066
2387,2388,3522,2007-04-17 15:44:00,SimonP,-38,2007,26028
2388,2387,3523,2007-04-17 15:44:00,Natalie Erin,-2,2007,26026
2389,2386,3524,2007-04-17 15:44:00,Retired username,0,2007,26026
2390,2390,3520,2007-04-17 15:45:00,AEMoreira042281,129,2007,26155
2391,2391,3519,2007-04-17 15:46:00,Zooomabooma,71,2007,26226
2392,2392,3518,2007-04-17 15:46:00,AEMoreira042281,-173,2007,26053
2393,2393,3515,2007-04-17 15:47:00,24.96.188.23,1,2007,26054
2394,2394,3514,2007-04-17 15:47:00,80.25.16.178,20,2007,26074
2395,2395,3517,2007-04-17 15:47:00,Jauerback,19,2007,26093
2396,2396,3516,2007-04-17 15:47:00,Dan East,281,2007,26374
2397,2400,3513,2007-04-17 15:48:00,Dan East,0,2007,26374
2398,2399,3510,2007-04-17 15:48:00,Timothyarnold85,6,2007,26380
2399,2397,3512,2007-04-17 15:48:00,Dan East,-4,2007,26376
2400,2398,3511,2007-04-17 15:48:00,75.192.82.192,279,2007,26655
2401,2401,3509,2007-04-17 15:49:00,Dan East,-2,2007,26653
2402,2402,3508,2007-04-17 15:49:00,75.192.82.192,166,2007,26819
2403,2403,3507,2007-04-17 15:50:00,Golbez,-33,2007,26786
2404,2404,3506,2007-04-17 15:50:00,65.125.16.6,0,2007,26786
2405,2405,3505,2007-04-17 15:50:00,Jeeny,52,2007,26838
2406,2406,3504,2007-04-17 15:50:00,Timothyarnold85,-20,2007,26818
2407,2407,3503,2007-04-17 15:50:00,JSmith9579,-44,2007,26774
2408,2409,3501,2007-04-17 15:51:00,Noclip,25,2007,26799
2409,2408,3500,2007-04-17 15:51:00,Dictyosiphonaceae,33,2007,26832
2410,2410,3502,2007-04-17 15:51:00,Golbez,-71,2007,26761
2411,2411,3499,2007-04-17 15:52:00,Dictyosiphonaceae,31,2007,26792
2412,2412,3498,2007-04-17 15:53:00,216.165.16.27,0,2007,26792
2413,2413,3497,2007-04-17 15:53:00,205.251.126.245,30,2007,26822
2414,2414,3496,2007-04-17 15:53:00,Golbez,-16,2007,26806
2415,2415,3495,2007-04-17 15:53:00,219.195.28.1,56,2007,26862
2416,2416,3494,2007-04-17 15:54:00,Madcoverboy,290,2007,27152
2417,2417,3493,2007-04-17 15:54:00,88.6.211.160,13,2007,27165
2418,2418,3492,2007-04-17 15:54:00,Golbez,-290,2007,26875
2419,2419,3491,2007-04-17 15:55:00,Jwalte04,6,2007,26881
2420,2420,3490,2007-04-17 15:56:00,Dictyosiphonaceae,-20,2007,26861
2421,2421,3489,2007-04-17 15:57:00,Dictyosiphonaceae,-2,2007,26859
2422,2422,3488,2007-04-17 15:58:00,AEMoreira042281,6,2007,26865
2423,2423,3487,2007-04-17 15:59:00,152.130.7.132,0,2007,26865
2424,2424,3486,2007-04-17 15:59:00,AEMoreira042281,-6,2007,26859
2425,2425,3485,2007-04-17 15:59:00,142.46.214.162,-11,2007,26848
2426,2426,3484,2007-04-17 15:59:00,Ryuch,-12,2007,26836
2427,2427,3483,2007-04-17 15:59:00,Golbez,0,2007,26836
2428,2428,3482,2007-04-17 15:59:00,Dan East,-48,2007,26788
2429,2429,3481,2007-04-17 16:00:00,Marcus Cyron,4,2007,26792
2430,2430,3480,2007-04-17 16:00:00,AEMoreira042281,-13,2007,26779
2431,2431,3479,2007-04-17 16:01:00,AEMoreira042281,47,2007,26826
2432,2435,3476,2007-04-17 16:02:00,24.57.86.210,362,2007,27188
2433,2434,3478,2007-04-17 16:02:00,W guice,-4,2007,27184
2434,2432,3475,2007-04-17 16:02:00,Noclip,1,2007,27185
2435,2433,3477,2007-04-17 16:02:00,Noclip,2,2007,27187
2436,2436,3474,2007-04-17 16:03:00,Spencewah,81,2007,27268
2437,2437,3473,2007-04-17 16:03:00,FieldNorth,111,2007,27379
2438,2438,3472,2007-04-17 16:04:00,Spencewah,1,2007,27380
2439,2439,3471,2007-04-17 16:04:00,208.27.92.181,7,2007,27387
2440,2440,3470,2007-04-17 16:04:00,MoRsE,1,2007,27388
2441,2441,3469,2007-04-17 16:04:00,128.91.129.194,23,2007,27411
2442,2442,3468,2007-04-17 16:05:00,Dictyosiphonaceae,-135,2007,27276
2443,2443,3467,2007-04-17 16:05:00,Golbez,-7,2007,27269
2444,2446,3466,2007-04-17 16:06:00,FieldNorth,193,2007,27462
2445,2445,3465,2007-04-17 16:06:00,The Cosmonaut,0,2007,27462
2446,2444,3464,2007-04-17 16:06:00,Noclip,-28,2007,27434
2447,2447,3461,2007-04-17 16:07:00,Netscott,-13,2007,27421
2448,2448,3463,2007-04-17 16:07:00,Dictyosiphonaceae,-37,2007,27384
2449,2449,3462,2007-04-17 16:07:00,65.254.5.139,1,2007,27385
2450,2450,3460,2007-04-17 16:08:00,Madcoverboy,286,2007,27671
2451,2451,3458,2007-04-17 16:09:00,Armanikid,9,2007,27680
2452,2452,3457,2007-04-17 16:09:00,Rdfox 76,8,2007,27688
2453,2453,3459,2007-04-17 16:09:00,Tony1973,91,2007,27779
2454,2454,3456,2007-04-17 16:10:00,Tony1973,0,2007,27779
2455,2456,3454,2007-04-17 16:11:00,Rdfox 76,1,2007,27780
2456,2455,3455,2007-04-17 16:11:00,Armanikid,-3,2007,27777
2457,2457,3453,2007-04-17 16:13:00,Armanikid,-10,2007,27767
2458,2458,3452,2007-04-17 16:13:00,Dictyosiphonaceae,-21,2007,27746
2459,2459,3449,2007-04-17 16:14:00,Mikehelms,2,2007,27748
2460,2460,3451,2007-04-17 16:14:00,Flamebroil,12,2007,27760
2461,2461,3450,2007-04-17 16:14:00,71.142.68.108,0,2007,27760
2462,2462,3448,2007-04-17 16:15:00,Dictyosiphonaceae,-1,2007,27759
2463,2463,3447,2007-04-17 16:15:00,65.210.47.210,8,2007,27767
2464,2466,3444,2007-04-17 16:16:00,Rdfox 76,-8,2007,27759
2465,2465,3445,2007-04-17 16:16:00,Sirex98,0,2007,27759
2466,2464,3446,2007-04-17 16:16:00,Golbez,16,2007,27775
2467,2467,3443,2007-04-17 16:17:00,65.210.47.210,10,2007,27785
2468,2468,3442,2007-04-17 16:17:00,Janviermichelle,216,2007,28001
2469,2469,3439,2007-04-17 16:18:00,Janviermichelle,-24,2007,27977
2470,2470,3437,2007-04-17 16:18:00,Golbez,-10,2007,27967
2471,2471,3438,2007-04-17 16:18:00,Zehly,4,2007,27971
2472,2472,3441,2007-04-17 16:18:00,AcePuppy,-7,2007,27964
2473,2473,3440,2007-04-17 16:18:00,Kizor,0,2007,27964
2474,2475,3435,2007-04-17 16:19:00,MartinBot,-31,2007,27933
2475,2474,3436,2007-04-17 16:19:00,66.193.5.99,31,2007,27964
2476,2477,3433,2007-04-17 16:20:00,Sgt Pinback,24,2007,27988
2477,2478,3432,2007-04-17 16:20:00,Ronnotel,0,2007,27988
2478,2476,3434,2007-04-17 16:20:00,192.132.64.2,253,2007,28241
2479,2479,3431,2007-04-17 16:21:00,192.132.64.2,2,2007,28243
2480,2480,3430,2007-04-17 16:21:00,Tvsnow,473,2007,28716
2481,2481,3427,2007-04-17 16:22:00,61.95.184.98,60,2007,28776
2482,2482,3429,2007-04-17 16:22:00,Rdfox 76,1,2007,28777
2483,2483,3428,2007-04-17 16:22:00,Sgt Pinback,12,2007,28789
2484,2484,3426,2007-04-17 16:23:00,220.86.46.194,12,2007,28801
2485,2485,3425,2007-04-17 16:23:00,Tvsnow,134,2007,28935
2486,2491,3419,2007-04-17 16:25:00,Sgt Pinback,-3,2007,28932
2487,2490,3420,2007-04-17 16:25:00,EamonnPKeane,-4,2007,28928
2488,2489,3421,2007-04-17 16:25:00,Tvsnow,-30,2007,28898
2489,2488,3422,2007-04-17 16:25:00,Dan East,5,2007,28903
2490,2487,3423,2007-04-17 16:25:00,Rdfox 76,-60,2007,28843
2491,2486,3424,2007-04-17 16:25:00,24.172.163.242,-59,2007,28784
2492,2492,3418,2007-04-17 16:26:00,65.173.228.59,28,2007,28812
2493,2493,3417,2007-04-17 16:26:00,Tvsnow,2,2007,28814
2494,2494,3416,2007-04-17 16:26:00,Bvjrm,0,2007,28814
2495,2495,3415,2007-04-17 16:27:00,AEMoreira042281,71,2007,28885
2496,2496,3414,2007-04-17 16:27:00,Tvsnow,4,2007,28889
2497,2497,3413,2007-04-17 16:28:00,Energyfreezer,0,2007,28889
2498,2498,3412,2007-04-17 16:28:00,AEMoreira042281,37,2007,28926
2499,2501,3409,2007-04-17 16:29:00,Zenohockey,4,2007,28930
2500,2500,3410,2007-04-17 16:29:00,221.134.249.236,75,2007,29005
2501,2499,3411,2007-04-17 16:29:00,74.194.33.191,197,2007,29202
2502,2502,3408,2007-04-17 16:30:00,192.132.64.2,4,2007,29206
2503,2503,3407,2007-04-17 16:30:00,Sgt Pinback,17,2007,29223
2504,2504,3406,2007-04-17 16:30:00,Zehly,17,2007,29240
2505,2505,3405,2007-04-17 16:30:00,Tvsnow,259,2007,29499
2506,2510,3404,2007-04-17 16:31:00,Saforrest,-12,2007,29487
2507,2509,3403,2007-04-17 16:31:00,Jpers36,48,2007,29535
2508,2511,3402,2007-04-17 16:31:00,BBnet3000,0,2007,29535
2509,2507,3400,2007-04-17 16:31:00,AEMoreira042281,48,2007,29583
2510,2506,3399,2007-04-17 16:31:00,Sgt Pinback,9,2007,29592
2511,2508,3401,2007-04-17 16:31:00,Iceberg007,236,2007,29828
2512,2512,3398,2007-04-17 16:32:00,Tvsnow,5,2007,29833
2513,2513,3397,2007-04-17 16:33:00,RickRobbins,80,2007,29913
2514,2514,3396,2007-04-17 16:33:00,Sgt Pinback,1,2007,29914
2515,2515,3395,2007-04-17 16:33:00,Kizor,-6,2007,29908
2516,2516,3394,2007-04-17 16:33:00,139.48.81.98,169,2007,30077
2517,2517,3393,2007-04-17 16:33:00,AEMoreira042281,32,2007,30109
2518,2518,3392,2007-04-17 16:33:00,Dan East,62,2007,30171
2519,2519,3391,2007-04-17 16:34:00,Kizor,6,2007,30177
2520,2520,3390,2007-04-17 16:34:00,Abe Lincoln,46,2007,30223
2521,2524,3386,2007-04-17 16:35:00,Dan East,-25,2007,30198
2522,2523,3387,2007-04-17 16:35:00,Zenohockey,-1,2007,30197
2523,2521,3389,2007-04-17 16:35:00,Rdfox 76,-169,2007,30028
2524,2522,3388,2007-04-17 16:35:00,Abe Lincoln,0,2007,30028
2525,2525,3385,2007-04-17 16:36:00,Liamh1,0,2007,30028
2526,2526,3384,2007-04-17 16:36:00,W guice,1,2007,30029
2527,2527,3383,2007-04-17 16:36:00,Iceberg007,126,2007,30155
2528,2528,3382,2007-04-17 16:36:00,W guice,-1,2007,30154
2529,2529,3381,2007-04-17 16:36:00,Zenohockey,-7,2007,30147
2530,2530,3380,2007-04-17 16:36:00,69.47.26.37,59,2007,30206
2531,2532,3376,2007-04-17 16:37:00,Fsu23phd,-4,2007,30202
2532,2531,3375,2007-04-17 16:37:00,69.47.26.37,1,2007,30203
2533,2533,3379,2007-04-17 16:37:00,Fsu23phd,234,2007,30437
2534,2534,3378,2007-04-17 16:37:00,Rdfox 76,-43,2007,30394
2535,2535,3377,2007-04-17 16:37:00,Iceberg007,0,2007,30394
2536,2536,3374,2007-04-17 16:38:00,AEMoreira042281,1,2007,30395
2537,2537,3373,2007-04-17 16:38:00,Iceberg007,3,2007,30398
2538,2538,3372,2007-04-17 16:38:00,RickRobbins,-3,2007,30395
2539,2544,3371,2007-04-17 16:39:00,Swaun,497,2007,30892
2540,2543,3369,2007-04-17 16:39:00,164.113.8.13,4,2007,30896
2541,2542,3370,2007-04-17 16:39:00,Iceberg007,8,2007,30904
2542,2540,3368,2007-04-17 16:39:00,Iceberg007,-8,2007,30896
2543,2539,3366,2007-04-17 16:39:00,Stripes238,4,2007,30900
2544,2541,3367,2007-04-17 16:39:00,Dan East,31,2007,30931
2545,2545,3360,2007-04-17 16:40:00,Madcoverboy,3,2007,30934
2546,2546,3361,2007-04-17 16:40:00,AEMoreira042281,4,2007,30938
2547,2547,3365,2007-04-17 16:40:00,W guice,-4,2007,30934
2548,2548,3363,2007-04-17 16:40:00,Abe Lincoln,0,2007,30934
2549,2549,3364,2007-04-17 16:40:00,Starks,37,2007,30971
2550,2550,3362,2007-04-17 16:40:00,W guice,-58,2007,30913
2551,2551,3359,2007-04-17 16:41:00,Madcoverboy,-3,2007,30910
2552,2552,3358,2007-04-17 16:41:00,Stripes238,15,2007,30925
2553,2553,3357,2007-04-17 16:41:00,Dan East,-1,2007,30924
2554,2554,3356,2007-04-17 16:41:00,W guice,1,2007,30925
2555,2555,3355,2007-04-17 16:41:00,82.38.212.107,60,2007,30985
2556,2556,3354,2007-04-17 16:41:00,Kizor,-48,2007,30937
2557,2559,3353,2007-04-17 16:42:00,Muntuwandi,203,2007,31140
2558,2560,3351,2007-04-17 16:42:00,Kizor,-3,2007,31137
2559,2557,3350,2007-04-17 16:42:00,Netscott,0,2007,31137
2560,2558,3352,2007-04-17 16:42:00,AEMoreira042281,10,2007,31147
2561,2563,3347,2007-04-17 16:43:00,Iceberg007,-3,2007,31144
2562,2564,3346,2007-04-17 16:43:00,Abe Lincoln,-50,2007,31094
2563,2561,3349,2007-04-17 16:43:00,Ronnotel,-53,2007,31041
2564,2562,3348,2007-04-17 16:43:00,Kizor,-60,2007,30981
2565,2565,3345,2007-04-17 16:43:00,Zenohockey,-1,2007,30980
2566,2567,3343,2007-04-17 16:44:00,AEMoreira042281,1,2007,30981
2567,2566,3342,2007-04-17 16:44:00,Lmcelhiney,1,2007,30982
2568,2568,3344,2007-04-17 16:44:00,Lulu72188,0,2007,30982
2569,2573,3339,2007-04-17 16:46:00,130.49.147.25,-5,2007,30977
2570,2571,3341,2007-04-17 16:46:00,Rdfox 76,348,2007,31325
2571,2572,3340,2007-04-17 16:46:00,Dan East,0,2007,31325
2572,2570,3338,2007-04-17 16:46:00,AEMoreira042281,37,2007,31362
2573,2569,3337,2007-04-17 16:46:00,193.216.2.228,1,2007,31363
2574,2574,3330,2007-04-17 16:47:00,Swaun,210,2007,31573
2575,2575,3332,2007-04-17 16:47:00,Ronnotel,0,2007,31573
2576,2576,3329,2007-04-17 16:47:00,Craigharmon,0,2007,31573
2577,2577,3334,2007-04-17 16:47:00,Abe Lincoln,7,2007,31580
2578,2578,3335,2007-04-17 16:47:00,W guice,0,2007,31580
2579,2579,3336,2007-04-17 16:47:00,Stahlman,127,2007,31707
2580,2580,3333,2007-04-17 16:47:00,130.49.147.25,-5,2007,31702
2581,2581,3331,2007-04-17 16:47:00,142.35.4.130,24,2007,31726
2582,2583,3327,2007-04-17 16:48:00,Ronnotel,-500,2007,31226
2583,2582,3328,2007-04-17 16:48:00,142.35.4.130,-24,2007,31202
2584,2584,3326,2007-04-17 16:49:00,Ronnotel,3,2007,31205
2585,2585,3325,2007-04-17 16:50:00,Ronnotel,1,2007,31206
2586,2586,3324,2007-04-17 16:50:00,Isaacsurh,1,2007,31207
2587,2587,3322,2007-04-17 16:51:00,Tarikur,9,2007,31216
2588,2588,3323,2007-04-17 16:51:00,Kevinp2,43,2007,31259
2589,2589,3320,2007-04-17 16:52:00,69.3.135.68,65,2007,31324
2590,2590,3321,2007-04-17 16:52:00,24.90.8.71,3,2007,31327
2591,2591,3319,2007-04-17 16:53:00,Gauge00,441,2007,31768
2592,2595,3316,2007-04-17 16:54:00,Abe Lincoln,-348,2007,31420
2593,2594,3318,2007-04-17 16:54:00,Daysleeper47,-230,2007,31190
2594,2592,3317,2007-04-17 16:54:00,Ronnotel,4,2007,31194
2595,2593,3315,2007-04-17 16:54:00,Muntuwandi,0,2007,31194
2596,2596,3314,2007-04-17 16:55:00,71.142.68.108,22,2007,31216
2597,2597,3313,2007-04-17 16:55:00,StuffOfInterest,-1,2007,31215
2598,2598,3312,2007-04-17 16:56:00,Ronnotel,6,2007,31221
2599,2599,3311,2007-04-17 16:56:00,Kevinp2,421,2007,31642
2600,2600,3307,2007-04-17 16:57:00,Timothyarnold85,0,2007,31642
2601,2601,3309,2007-04-17 16:57:00,Satesclop,102,2007,31744
2602,2602,3308,2007-04-17 16:57:00,Ronnotel,6,2007,31750
2603,2605,3305,2007-04-17 16:58:00,Visor,-2,2007,31748
2604,2604,3304,2007-04-17 16:58:00,192.45.72.26,29,2007,31777
2605,2603,3306,2007-04-17 16:58:00,Ronnotel,-14,2007,31763
2606,2606,3303,2007-04-17 16:59:00,24.93.100.99,46,2007,31809
2607,2607,3302,2007-04-17 16:59:00,Batman2005,0,2007,31809
2608,2608,3301,2007-04-17 16:59:00,68.154.135.201,81,2007,31890
2609,2609,3297,2007-04-17 17:00:00,Manufracture,0,2007,31890
2610,2610,3300,2007-04-17 17:00:00,Manufracture,16,2007,31906
2611,2611,3299,2007-04-17 17:00:00,M.S.K.,-3,2007,31903
2612,2612,3298,2007-04-17 17:00:00,Swaun,53,2007,31956
2613,2613,3295,2007-04-17 17:01:00,Netscott,1,2007,31957
2614,2614,3296,2007-04-17 17:01:00,Netscott,8,2007,31965
2615,2619,3292,2007-04-17 17:02:00,NPUGelb,0,2007,31965
2616,2618,3293,2007-04-17 17:02:00,151.199.193.13,-2,2007,31963
2617,2616,3291,2007-04-17 17:02:00,M.S.K.,0,2007,31963
2618,2617,3294,2007-04-17 17:02:00,Netscott,-1,2007,31962
2619,2615,3290,2007-04-17 17:02:00,Netscott,10,2007,31972
2620,2620,3289,2007-04-17 17:03:00,206.186.37.201,-6,2007,31966
2621,2621,3288,2007-04-17 17:03:00,Just Chilling,17,2007,31983
2622,2622,3287,2007-04-17 17:03:00,Bellhalla,8,2007,31991
2623,2627,3286,2007-04-17 17:04:00,Abe Lincoln,0,2007,31991
2624,2626,3285,2007-04-17 17:04:00,Rarelibra,-8,2007,31983
2625,2628,3284,2007-04-17 17:04:00,Rdfox 76,-483,2007,31500
2626,2624,3283,2007-04-17 17:04:00,Netscott,5,2007,31505
2627,2623,3281,2007-04-17 17:04:00,68.191.7.174,-7,2007,31498
2628,2625,3282,2007-04-17 17:04:00,Abe Lincoln,-4,2007,31494
2629,2629,3280,2007-04-17 17:05:00,Bellhalla,8,2007,31502
2630,2630,3279,2007-04-17 17:05:00,Abe Lincoln,0,2007,31502
2631,2631,3278,2007-04-17 17:05:00,74.118.214.96,0,2007,31502
2632,2632,3277,2007-04-17 17:05:00,24.93.100.99,57,2007,31559
2633,2633,3276,2007-04-17 17:05:00,68.96.193.193,34,2007,31593
2634,2634,3271,2007-04-17 17:06:00,Th1rt3en,0,2007,31593
2635,2635,3272,2007-04-17 17:06:00,Swaun,118,2007,31711
2636,2636,3273,2007-04-17 17:06:00,Tom,-56,2007,31655
2637,2637,3275,2007-04-17 17:06:00,69.138.169.219,67,2007,31722
2638,2638,3274,2007-04-17 17:06:00,Abe Lincoln,-70,2007,31652
2639,2641,3268,2007-04-17 17:07:00,205.174.123.106,0,2007,31652
2640,2639,3269,2007-04-17 17:07:00,Abe Lincoln,20,2007,31672
2641,2640,3270,2007-04-17 17:07:00,192.44.136.103,312,2007,31984
2642,2642,3267,2007-04-17 17:08:00,141.212.160.75,-7,2007,31977
2643,2643,3266,2007-04-17 17:08:00,72.65.182.207,78,2007,32055
2644,2644,3265,2007-04-17 17:08:00,Seawolf12,43,2007,32098
2645,2645,3264,2007-04-17 17:09:00,Abe Lincoln,7,2007,32105
2646,2646,3263,2007-04-17 17:09:00,Rdfox 76,-43,2007,32062
2647,2647,3262,2007-04-17 17:09:00,Ronnotel,-3,2007,32059
2648,2648,3261,2007-04-17 17:09:00,NawlinWiki,0,2007,32059
2649,2650,3258,2007-04-17 17:10:00,192.44.136.103,0,2007,32059
2650,2649,3257,2007-04-17 17:10:00,Abe.Froman,34,2007,32093
2651,2651,3260,2007-04-17 17:10:00,Craigharmon,0,2007,32093
2652,2652,3259,2007-04-17 17:10:00,Tom,-34,2007,32059
2653,2653,3256,2007-04-17 17:11:00,Batman2005,-8,2007,32051
2654,2654,3255,2007-04-17 17:11:00,Just Chilling,0,2007,32051
2655,2655,3254,2007-04-17 17:11:00,Cristo39,0,2007,32051
2656,2656,3253,2007-04-17 17:11:00,Abe.Froman,0,2007,32051
2657,2658,3251,2007-04-17 17:12:00,72.65.182.207,8,2007,32059
2658,2657,3252,2007-04-17 17:12:00,129.118.2.85,-3,2007,32056
2659,2659,3250,2007-04-17 17:12:00,Energyfreezer,-14,2007,32042
2660,2664,3248,2007-04-17 17:13:00,129.15.131.251,1,2007,32043
2661,2662,3246,2007-04-17 17:13:00,NawlinWiki,-82,2007,31961
2662,2663,3249,2007-04-17 17:13:00,Mr Ernie,0,2007,31961
2663,2661,3245,2007-04-17 17:13:00,Daysleeper47,68,2007,32029
2664,2660,3247,2007-04-17 17:13:00,Scientz,0,2007,32029
2665,2665,3244,2007-04-17 17:14:00,Tom,4,2007,32033
2666,2666,3243,2007-04-17 17:14:00,Just Chilling,0,2007,32033
2667,2667,3242,2007-04-17 17:14:00,Wwallacee,0,2007,32033
2668,2668,3241,2007-04-17 17:14:00,74.9.68.226,4,2007,32037
2669,2669,3240,2007-04-17 17:15:00,NawlinWiki,-14,2007,32023
2670,2670,3239,2007-04-17 17:15:00,66.251.1.226,20,2007,32043
2671,2671,3238,2007-04-17 17:15:00,KnowHow~enwiki,61,2007,32104
2672,2672,3237,2007-04-17 17:15:00,Abe Lincoln,0,2007,32104
2673,2673,3236,2007-04-17 17:15:00,KnowHow~enwiki,78,2007,32182
2674,2678,3233,2007-04-17 17:16:00,Natalie Erin,-72,2007,32110
2675,2677,3234,2007-04-17 17:16:00,Netscott,13,2007,32123
2676,2674,3231,2007-04-17 17:16:00,148.238.10.253,78,2007,32201
2677,2675,3232,2007-04-17 17:16:00,Netscott,-3,2007,32198
2678,2676,3235,2007-04-17 17:16:00,70.46.15.166,33,2007,32231
2679,2679,3230,2007-04-17 17:17:00,Just Chilling,-13,2007,32218
2680,2680,3229,2007-04-17 17:17:00,Abe Lincoln,-85,2007,32133
2681,2681,3228,2007-04-17 17:17:00,Natalie Erin,10,2007,32143
2682,2682,3227,2007-04-17 17:17:00,64.114.88.33,4,2007,32147
2683,2683,3226,2007-04-17 17:17:00,FruitcakeNL,-4,2007,32143
2684,2684,3225,2007-04-17 17:17:00,Coemgenus,8,2007,32151
2685,2688,3222,2007-04-17 17:18:00,125.233.67.196,4,2007,32155
2686,2687,3224,2007-04-17 17:18:00,Nyttend,0,2007,32155
2687,2685,3221,2007-04-17 17:18:00,Coemgenus,0,2007,32155
2688,2686,3223,2007-04-17 17:18:00,Rdfox 76,-78,2007,32077
2689,2689,3219,2007-04-17 17:19:00,158.59.242.175,13,2007,32090
2690,2690,3218,2007-04-17 17:19:00,Sgt Pinback,-4,2007,32086
2691,2691,3217,2007-04-17 17:19:00,129.174.172.211,194,2007,32280
2692,2692,3220,2007-04-17 17:19:00,Coemgenus,-4,2007,32276
2693,2696,3213,2007-04-17 17:20:00,Sgt Pinback,11,2007,32287
2694,2693,3216,2007-04-17 17:20:00,Rdfox 76,0,2007,32287
2695,2694,3215,2007-04-17 17:20:00,125.233.67.196,8,2007,32295
2696,2695,3214,2007-04-17 17:20:00,199.111.195.118,-11,2007,32284
2697,2697,3212,2007-04-17 17:20:00,125.233.67.196,33,2007,32317
2698,2702,3208,2007-04-17 17:21:00,Corvokarasu,28,2007,32345
2699,2701,3209,2007-04-17 17:21:00,Bob f it,-33,2007,32312
2700,2698,3206,2007-04-17 17:21:00,Abe Lincoln,-278,2007,32034
2701,2699,3207,2007-04-17 17:21:00,125.233.67.196,12,2007,32046
2702,2703,3211,2007-04-17 17:21:00,125.233.67.196,0,2007,32046
2703,2700,3210,2007-04-17 17:21:00,66.251.1.226,235,2007,32281
2704,2711,3204,2007-04-17 17:22:00,64.236.128.27,314,2007,32595
2705,2710,3203,2007-04-17 17:22:00,Rdfox 76,-8,2007,32587
2706,2713,3200,2007-04-17 17:22:00,Legionstrife,268,2007,32855
2707,2712,3205,2007-04-17 17:22:00,Netscott,33,2007,32888
2708,2708,3201,2007-04-17 17:22:00,Corvokarasu,19,2007,32907
2709,2707,3197,2007-04-17 17:22:00,Sgt Pinback,-8,2007,32899
2710,2706,3196,2007-04-17 17:22:00,68.33.91.169,154,2007,33053
2711,2705,3195,2007-04-17 17:22:00,Corvokarasu,0,2007,33053
2712,2704,3198,2007-04-17 17:22:00,Abe Lincoln,0,2007,33053
2713,2709,3202,2007-04-17 17:22:00,66.251.1.226,6,2007,33059
2714,2719,3189,2007-04-17 17:23:00,Corvokarasu,-4,2007,33055
2715,2714,3194,2007-04-17 17:23:00,Pupster21,-1,2007,33054
2716,2715,3193,2007-04-17 17:23:00,125.233.67.196,1,2007,33055
2717,2716,3192,2007-04-17 17:23:00,Dan East,498,2007,33553
2718,2717,3191,2007-04-17 17:23:00,Rdfox 76,117,2007,33670
2719,2718,3190,2007-04-17 17:23:00,Abe Lincoln,0,2007,33670
2720,2726,3186,2007-04-17 17:24:00,204.184.17.101,0,2007,33670
2721,2725,3185,2007-04-17 17:24:00,125.233.67.196,0,2007,33670
2722,2724,3188,2007-04-17 17:24:00,Abe Lincoln,247,2007,33917
2723,2720,3180,2007-04-17 17:24:00,125.233.67.196,31,2007,33948
2724,2722,3182,2007-04-17 17:24:00,130.126.166.236,-94,2007,33854
2725,2721,3181,2007-04-17 17:24:00,Swaun,36,2007,33890
2726,2727,3187,2007-04-17 17:24:00,MEvanov,-1,2007,33889
2727,2723,3183,2007-04-17 17:24:00,66.251.1.226,-4,2007,33885
2728,2728,3184,2007-04-17 17:24:00,Bradleyjx,-12,2007,33873
2729,2730,3175,2007-04-17 17:25:00,66.251.1.226,-219,2007,33654
2730,2734,3179,2007-04-17 17:25:00,129.174.172.211,63,2007,33717
2731,2733,3177,2007-04-17 17:25:00,Sulfiteboy,1,2007,33718
2732,2729,3174,2007-04-17 17:25:00,Netscott,22,2007,33740
2733,2731,3176,2007-04-17 17:25:00,Gilliam,-31,2007,33709
2734,2732,3178,2007-04-17 17:25:00,Fluzwup,0,2007,33709
2735,2740,3168,2007-04-17 17:26:00,Esprix,-5,2007,33704
2736,2739,3169,2007-04-17 17:26:00,89.241.238.178,-1,2007,33703
2737,2738,3170,2007-04-17 17:26:00,70.160.163.178,-11,2007,33692
2738,2741,3167,2007-04-17 17:26:00,Mikethegreen,17,2007,33709
2739,2736,3172,2007-04-17 17:26:00,Netscott,-26,2007,33683
2740,2735,3173,2007-04-17 17:26:00,Maelnuneb,-4,2007,33679
2741,2737,3171,2007-04-17 17:26:00,220.255.205.147,16,2007,33695
2742,2742,3164,2007-04-17 17:27:00,Nyttend,-2,2007,33693
2743,2743,3166,2007-04-17 17:27:00,220.255.205.147,-16,2007,33677
2744,2744,3165,2007-04-17 17:27:00,Dan East,-498,2007,33179
2745,2748,3160,2007-04-17 17:28:00,Jpers36,-58,2007,33121
2746,2745,3163,2007-04-17 17:28:00,Kizor,76,2007,33197
2747,2746,3162,2007-04-17 17:28:00,Mikethegreen,16,2007,33213
2748,2747,3161,2007-04-17 17:28:00,128.252.62.63,0,2007,33213
2749,2749,3159,2007-04-17 17:28:00,Nyttend,0,2007,33213
2750,2750,3158,2007-04-17 17:29:00,Valadius,0,2007,33213
2751,2751,3157,2007-04-17 17:29:00,82.112.138.39,-47,2007,33166
2752,2756,3152,2007-04-17 17:30:00,Batman2005,0,2007,33166
2753,2757,3156,2007-04-17 17:30:00,Flamebroil,1,2007,33167
2754,2755,3154,2007-04-17 17:30:00,Kizor,-315,2007,32852
2755,2753,3151,2007-04-17 17:30:00,Smokefan2007,87,2007,32939
2756,2754,3155,2007-04-17 17:30:00,204.154.43.244,25,2007,32964
2757,2752,3153,2007-04-17 17:30:00,Nyttend,23,2007,32987
2758,2758,3150,2007-04-17 17:31:00,Kizor,0,2007,32987
2759,2759,3149,2007-04-17 17:31:00,Abe Lincoln,5,2007,32992
2760,2760,3148,2007-04-17 17:31:00,Nyttend,0,2007,32992
2761,2761,3147,2007-04-17 17:31:00,RoyBatty42,196,2007,33188
2762,2762,3146,2007-04-17 17:32:00,129.118.120.12,-1,2007,33187
2763,2763,3145,2007-04-17 17:32:00,Fluzwup,1,2007,33188
2764,2764,3144,2007-04-17 17:32:00,Mayorcheese,14,2007,33202
2765,2768,3143,2007-04-17 17:33:00,Nyttend,44,2007,33246
2766,2767,3142,2007-04-17 17:33:00,222.101.164.93,-1,2007,33245
2767,2766,3141,2007-04-17 17:33:00,Themanwithoutapast,0,2007,33245
2768,2765,3140,2007-04-17 17:33:00,81.98.125.108,2,2007,33247
2769,2769,3138,2007-04-17 17:34:00,NPUGelb,-30,2007,33217
2770,2770,3139,2007-04-17 17:34:00,Kizor,114,2007,33331
2771,2771,3137,2007-04-17 17:35:00,Zehly,239,2007,33570
2772,2772,3136,2007-04-17 17:35:00,Ryanluck,0,2007,33570
2773,2773,3135,2007-04-17 17:35:00,Batman2005,0,2007,33570
2774,2774,3134,2007-04-17 17:35:00,Jeeny,28,2007,33598
2775,2775,3133,2007-04-17 17:35:00,Kizor,26,2007,33624
2776,2777,3131,2007-04-17 17:36:00,Abe Lincoln,-91,2007,33533
2777,2778,3130,2007-04-17 17:36:00,68.60.42.209,210,2007,33743
2778,2776,3132,2007-04-17 17:36:00,Ektar,113,2007,33856
2779,2779,3129,2007-04-17 17:37:00,Slongwill,32,2007,33888
2780,2780,3128,2007-04-17 17:38:00,71.244.157.89,123,2007,34011
2781,2781,3126,2007-04-17 17:39:00,Lucid,0,2007,34011
2782,2782,3127,2007-04-17 17:39:00,Ektar,7,2007,34018
2783,2787,3120,2007-04-17 17:40:00,Corvokarasu,10,2007,34028
2784,2783,3124,2007-04-17 17:40:00,The Letter J,21,2007,34049
2785,2784,3123,2007-04-17 17:40:00,TikiTDO,7,2007,34056
2786,2785,3122,2007-04-17 17:40:00,Tomtheman5,9,2007,34065
2787,2786,3121,2007-04-17 17:40:00,Chunky Rice,-123,2007,33942
2788,2788,3125,2007-04-17 17:40:00,220.255.205.147,16,2007,33958
2789,2789,3119,2007-04-17 17:41:00,THF,-240,2007,33718
2790,2790,3118,2007-04-17 17:42:00,Kntrabssi,-7,2007,33711
2791,2791,3117,2007-04-17 17:42:00,24.173.220.30,0,2007,33711
2792,2792,3116,2007-04-17 17:42:00,Jobnikon,4,2007,33715
2793,2793,3113,2007-04-17 17:43:00,Xakuzzah,4,2007,33719
2794,2794,3114,2007-04-17 17:43:00,86.40.215.27,12,2007,33731
2795,2795,3115,2007-04-17 17:43:00,220.255.205.147,-16,2007,33715
2796,2798,3110,2007-04-17 17:44:00,THF,68,2007,33783
2797,2799,3109,2007-04-17 17:44:00,Moncrief,10,2007,33793
2798,2796,3112,2007-04-17 17:44:00,Moncrief,0,2007,33793
2799,2797,3111,2007-04-17 17:44:00,Coemgenus,-12,2007,33781
2800,2802,3106,2007-04-17 17:45:00,Moncrief,8,2007,33789
2801,2800,3108,2007-04-17 17:45:00,68.60.42.209,240,2007,34029
2802,2801,3107,2007-04-17 17:45:00,Scientz,-19,2007,34010
2803,2803,3102,2007-04-17 17:46:00,Arsonal,72,2007,34082
2804,2804,3104,2007-04-17 17:46:00,Netscott,0,2007,34082
2805,2805,3105,2007-04-17 17:46:00,24.124.70.5,0,2007,34082
2806,2806,3103,2007-04-17 17:46:00,The Letter J,-72,2007,34010
2807,2807,3101,2007-04-17 17:47:00,Daveswagon,-2,2007,34008
2808,2808,3100,2007-04-17 17:48:00,85.165.132.39,-240,2007,33768
2809,2809,3099,2007-04-17 17:48:00,Natalie Erin,1,2007,33769
2810,2810,3098,2007-04-17 17:48:00,Kevinp2,-68,2007,33701
2811,2811,3097,2007-04-17 17:48:00,THF,19,2007,33720
2812,2817,3094,2007-04-17 17:49:00,Arsonal,-71,2007,33649
2813,2816,3096,2007-04-17 17:49:00,Natalie Erin,13,2007,33662
2814,2815,3095,2007-04-17 17:49:00,Natalie Erin,1,2007,33663
2815,2812,3091,2007-04-17 17:49:00,NawlinWiki,4,2007,33667
2816,2813,3093,2007-04-17 17:49:00,71.57.125.66,-32,2007,33635
2817,2814,3092,2007-04-17 17:49:00,Sgt Pinback,4,2007,33639
2818,2818,3090,2007-04-17 17:50:00,Scheibenzahl,0,2007,33639
2819,2819,3089,2007-04-17 17:50:00,UBeR,-10,2007,33629
2820,2820,3088,2007-04-17 17:50:00,71.244.157.89,266,2007,33895
2821,2824,3084,2007-04-17 17:51:00,204.225.63.10,190,2007,34085
2822,2823,3085,2007-04-17 17:51:00,Jeeny,-266,2007,33819
2823,2821,3087,2007-04-17 17:51:00,Natalie Erin,-4,2007,33815
2824,2822,3086,2007-04-17 17:51:00,Itsgeneb,-47,2007,33768
2825,2825,3083,2007-04-17 17:52:00,Swaun,298,2007,34066
2826,2826,3082,2007-04-17 17:53:00,76.107.132.67,-6,2007,34060
2827,2827,3081,2007-04-17 17:53:00,UBeR,-8,2007,34052
2828,2828,3079,2007-04-17 17:54:00,Natalie Erin,0,2007,34052
2829,2829,3080,2007-04-17 17:54:00,Swaun,5,2007,34057
2830,2832,3076,2007-04-17 17:55:00,155.82.73.253,30,2007,34087
2831,2830,3077,2007-04-17 17:55:00,Swaun,-6,2007,34081
2832,2831,3078,2007-04-17 17:55:00,129.89.253.115,59,2007,34140
2833,2833,3075,2007-04-17 17:56:00,Janviermichelle,19,2007,34159
2834,2834,3074,2007-04-17 17:56:00,Swaun,7,2007,34166
2835,2835,3070,2007-04-17 17:57:00,Just Chilling,-469,2007,33697
2836,2836,3073,2007-04-17 17:57:00,Youthman,3,2007,33700
2837,2837,3072,2007-04-17 17:57:00,65.197.19.246,-41,2007,33659
2838,2838,3071,2007-04-17 17:57:00,Corvokarasu,4,2007,33663
2839,2840,3069,2007-04-17 17:58:00,Swaun,-25,2007,33638
2840,2839,3068,2007-04-17 17:58:00,Chunky Rice,-3,2007,33635
2841,2842,3066,2007-04-17 17:59:00,Jeeny,-8,2007,33627
2842,2844,3064,2007-04-17 17:59:00,128.122.9.32,0,2007,33627
2843,2841,3067,2007-04-17 17:59:00,Youthman,0,2007,33627
2844,2843,3065,2007-04-17 17:59:00,64.4.104.2,-2,2007,33625
2845,2846,3062,2007-04-17 18:00:00,PubliusFL,2,2007,33627
2846,2845,3063,2007-04-17 18:00:00,65.222.156.17,4,2007,33631
2847,2847,3059,2007-04-17 18:01:00,PubliusFL,6,2007,33637
2848,2848,3060,2007-04-17 18:01:00,Netscott,7,2007,33644
2849,2849,3061,2007-04-17 18:01:00,65.222.156.17,4,2007,33648
2850,2850,3058,2007-04-17 18:02:00,Jgk009,9,2007,33657
2851,2851,3057,2007-04-17 18:02:00,Netscott,3,2007,33660
2852,2852,3056,2007-04-17 18:03:00,Coemgenus,-9,2007,33651
2853,2853,3055,2007-04-17 18:03:00,71.248.113.242,-1,2007,33650
2854,2854,3054,2007-04-17 18:03:00,Abrabryan,1,2007,33651
2855,2855,3053,2007-04-17 18:03:00,207.63.61.162,24,2007,33675
2856,2856,3052,2007-04-17 18:03:00,Coemgenus,-25,2007,33650
2857,2859,3050,2007-04-17 18:04:00,Swaun,102,2007,33752
2858,2857,3049,2007-04-17 18:04:00,Scientz,-19,2007,33733
2859,2858,3051,2007-04-17 18:04:00,Lucid,1,2007,33734
2860,2860,3047,2007-04-17 18:05:00,Natalie Erin,-2,2007,33732
2861,2861,3046,2007-04-17 18:05:00,83.216.28.44,14,2007,33746
2862,2862,3048,2007-04-17 18:05:00,204.97.253.244,2,2007,33748
2863,2866,3042,2007-04-17 18:06:00,70.176.64.56,34,2007,33782
2864,2863,3045,2007-04-17 18:06:00,Eam91,2,2007,33784
2865,2864,3044,2007-04-17 18:06:00,Natalie Erin,-5,2007,33779
2866,2865,3043,2007-04-17 18:06:00,Daveswagon,-1,2007,33778
2867,2869,3039,2007-04-17 18:07:00,209.7.193.3,4,2007,33782
2868,2867,3041,2007-04-17 18:07:00,Corvokarasu,-10,2007,33772
2869,2868,3040,2007-04-17 18:07:00,83.216.28.44,-25,2007,33747
2870,2870,3036,2007-04-17 18:08:00,209.7.246.70,10,2007,33757
2871,2871,3037,2007-04-17 18:08:00,Coemgenus,-4,2007,33753
2872,2872,3038,2007-04-17 18:08:00,DJFrankie2468,16,2007,33769
2873,2873,3035,2007-04-17 18:09:00,83.216.28.44,12,2007,33781
2874,2874,3034,2007-04-17 18:09:00,ElKevbo,1,2007,33782
2875,2875,3033,2007-04-17 18:09:00,Chunky Rice,-12,2007,33770
2876,2876,3032,2007-04-17 18:09:00,Lmcelhiney,121,2007,33891
2877,2877,3031,2007-04-17 18:10:00,ESkog,-10,2007,33881
2878,2879,3029,2007-04-17 18:11:00,Netscott,21,2007,33902
2879,2878,3030,2007-04-17 18:11:00,Kevinp2,26,2007,33928
2880,2880,3026,2007-04-17 18:12:00,Rgrof,19,2007,33947
2881,2881,3027,2007-04-17 18:12:00,Coemgenus,-6,2007,33941
2882,2882,3028,2007-04-17 18:12:00,209.68.98.14,6,2007,33947
2883,2883,3023,2007-04-17 18:13:00,209.68.98.14,13,2007,33960
2884,2884,3025,2007-04-17 18:13:00,Just Chilling,25,2007,33985
2885,2885,3024,2007-04-17 18:13:00,Luckyluke,184,2007,34169
2886,2890,3020,2007-04-17 18:14:00,63.239.86.251,-13,2007,34156
2887,2888,3022,2007-04-17 18:14:00,Ken from Dublin,375,2007,34531
2888,2889,3021,2007-04-17 18:14:00,128.173.82.81,87,2007,34618
2889,2886,3018,2007-04-17 18:14:00,Corvokarasu,0,2007,34618
2890,2887,3019,2007-04-17 18:14:00,Luckyluke,0,2007,34618
2891,2891,3017,2007-04-17 18:15:00,Just Chilling,-21,2007,34597
2892,2892,3016,2007-04-17 18:15:00,Just Chilling,-1,2007,34596
2893,2893,3015,2007-04-17 18:16:00,Natalie Erin,-24,2007,34572
2894,2894,3014,2007-04-17 18:16:00,Just Chilling,0,2007,34572
2895,2895,3012,2007-04-17 18:16:00,83.216.28.44,5,2007,34577
2896,2896,3013,2007-04-17 18:16:00,24.80.25.68,0,2007,34577
2897,2898,3010,2007-04-17 18:17:00,Fran Rogers,-4,2007,34573
2898,2897,3011,2007-04-17 18:17:00,Ken from Dublin,-1,2007,34572
2899,2899,3009,2007-04-17 18:17:00,24.80.25.68,0,2007,34572
2900,2902,3006,2007-04-17 18:18:00,Swatjester,-2,2007,34570
2901,2900,3008,2007-04-17 18:18:00,Fran Rogers,4,2007,34574
2902,2901,3007,2007-04-17 18:18:00,Rdfox 76,-6,2007,34568
2903,2906,3003,2007-04-17 18:19:00,MoRsE,91,2007,34659
2904,2903,3001,2007-04-17 18:19:00,Swatjester,-373,2007,34286
2905,2904,3002,2007-04-17 18:19:00,Ike9898,5,2007,34291
2906,2905,3004,2007-04-17 18:19:00,Netscott,7,2007,34298
2907,2907,3005,2007-04-17 18:19:00,199.33.141.137,-5,2007,34293
2908,2909,2999,2007-04-17 18:20:00,74.60.125.252,2,2007,34295
2909,2908,3000,2007-04-17 18:20:00,Netscott,6,2007,34301
2910,2913,2995,2007-04-17 18:21:00,Dcandeto,-3,2007,34298
2911,2912,2996,2007-04-17 18:21:00,Swatjester,-102,2007,34196
2912,2910,2998,2007-04-17 18:21:00,Dcandeto,-2,2007,34194
2913,2911,2997,2007-04-17 18:21:00,Natalie Erin,-6,2007,34188
2914,2914,2992,2007-04-17 18:22:00,Natalie Erin,0,2007,34188
2915,2915,2994,2007-04-17 18:22:00,Natalie Erin,102,2007,34290
2916,2916,2993,2007-04-17 18:22:00,Swatjester,115,2007,34405
2917,2917,2990,2007-04-17 18:23:00,Coemgenus,-54,2007,34351
2918,2918,2991,2007-04-17 18:23:00,63.100.44.98,54,2007,34405
2919,2921,2987,2007-04-17 18:24:00,Shefield11,54,2007,34459
2920,2919,2989,2007-04-17 18:24:00,Laurent Chouinard,442,2007,34901
2921,2920,2988,2007-04-17 18:24:00,70.91.67.178,-10,2007,34891
2922,2922,2982,2007-04-17 18:25:00,Coemgenus,10,2007,34901
2923,2923,2986,2007-04-17 18:25:00,Rdfox 76,-54,2007,34847
2924,2924,2985,2007-04-17 18:25:00,165.123.148.100,6,2007,34853
2925,2925,2984,2007-04-17 18:25:00,MoRsE,-1,2007,34852
2926,2926,2983,2007-04-17 18:25:00,216.204.186.46,0,2007,34852
2927,2928,2981,2007-04-17 18:26:00,Coemgenus,0,2007,34852
2928,2927,2979,2007-04-17 18:26:00,Swatjester,-10,2007,34842
2929,2929,2980,2007-04-17 18:26:00,Netscott,14,2007,34856
2930,2933,2976,2007-04-17 18:27:00,131.125.7.43,-1,2007,34855
2931,2932,2978,2007-04-17 18:27:00,Swatjester,10,2007,34865
2932,2934,2975,2007-04-17 18:27:00,Protiek,76,2007,34941
2933,2930,2977,2007-04-17 18:27:00,Plasma east,7,2007,34948
2934,2931,2974,2007-04-17 18:27:00,68.0.236.178,8,2007,34956
2935,2935,2973,2007-04-17 18:28:00,69.7.45.136,184,2007,35140
2936,2937,2971,2007-04-17 18:29:00,86.134.149.253,19,2007,35159
2937,2936,2972,2007-04-17 18:29:00,136.244.214.38,9,2007,35168
2938,2938,2970,2007-04-17 18:29:00,Netscott,-14,2007,35154
2939,2945,2969,2007-04-17 18:30:00,MartinBot,-19,2007,35135
2940,2946,2966,2007-04-17 18:30:00,RattleMan,0,2007,35135
2941,2943,2967,2007-04-17 18:30:00,ElKevbo,-47,2007,35088
2942,2944,2968,2007-04-17 18:30:00,Swatjester,-99,2007,34989
2943,2941,2965,2007-04-17 18:30:00,CR7,23,2007,35012
2944,2939,2962,2007-04-17 18:30:00,Rufus843,7,2007,35019
2945,2942,2964,2007-04-17 18:30:00,Threeafterthree,-355,2007,34664
2946,2940,2963,2007-04-17 18:30:00,12.183.52.52,15,2007,34679
2947,2947,2961,2007-04-17 18:31:00,Ike9898,4,2007,34683
2948,2948,2960,2007-04-17 18:31:00,SouthernNights,483,2007,35166
2949,2949,2959,2007-04-17 18:31:00,12.183.52.52,42,2007,35208
2950,2950,2958,2007-04-17 18:31:00,Rufus843,2,2007,35210
2951,2951,2957,2007-04-17 18:31:00,66.153.202.150,86,2007,35296
2952,2952,2956,2007-04-17 18:31:00,69.14.152.228,-268,2007,35028
2953,2954,2954,2007-04-17 18:32:00,209.158.100.19,0,2007,35028
2954,2955,2955,2007-04-17 18:32:00,Swatjester,-56,2007,34972
2955,2953,2953,2007-04-17 18:32:00,Coemgenus,268,2007,35240
2956,2956,2947,2007-04-17 18:33:00,204.152.2.80,130,2007,35370
2957,2957,2948,2007-04-17 18:33:00,Coemgenus,-86,2007,35284
2958,2958,2952,2007-04-17 18:33:00,Yllosubmarine,27,2007,35311
2959,2959,2950,2007-04-17 18:33:00,Coemgenus,0,2007,35311
2960,2960,2951,2007-04-17 18:33:00,Scientz,0,2007,35311
2961,2961,2949,2007-04-17 18:33:00,Kizor,12,2007,35323
2962,2964,2944,2007-04-17 18:34:00,SouthernNights,0,2007,35323
2963,2962,2946,2007-04-17 18:34:00,Kizor,1,2007,35324
2964,2963,2945,2007-04-17 18:34:00,Stevenscollege,0,2007,35324
2965,2967,2943,2007-04-17 18:35:00,LinguistAtLarge,101,2007,35425
2966,2966,2942,2007-04-17 18:35:00,66.153.202.150,86,2007,35511
2967,2965,2941,2007-04-17 18:35:00,Coemgenus,-86,2007,35425
2968,2968,2940,2007-04-17 18:36:00,66.153.202.150,86,2007,35511
2969,2969,2939,2007-04-17 18:37:00,Stevenscollege,-132,2007,35379
2970,2970,2938,2007-04-17 18:37:00,Coemgenus,-86,2007,35293
2971,2971,2937,2007-04-17 18:37:00,Natalie Erin,123,2007,35416
2972,2972,2936,2007-04-17 18:37:00,156.56.171.237,341,2007,35757
2973,2973,2935,2007-04-17 18:37:00,204.152.2.80,214,2007,35971
2974,2974,2934,2007-04-17 18:37:00,Natalie Erin,-130,2007,35841
2975,2975,2933,2007-04-17 18:38:00,Dingbat22,247,2007,36088
2976,2976,2932,2007-04-17 18:38:00,Rufus843,11,2007,36099
2977,2978,2930,2007-04-17 18:39:00,160.36.100.196,18,2007,36117
2978,2977,2931,2007-04-17 18:39:00,66.251.1.226,0,2007,36117
2979,2979,2929,2007-04-17 18:40:00,Cinemaniac86,7,2007,36124
2980,2980,2928,2007-04-17 18:40:00,Swatjester,160,2007,36284
2981,2981,2927,2007-04-17 18:40:00,81.232.62.11,0,2007,36284
2982,2982,2926,2007-04-17 18:41:00,Cinemaniac86,-4,2007,36280
2983,2983,2925,2007-04-17 18:41:00,160.36.100.196,0,2007,36280
2984,2984,2924,2007-04-17 18:41:00,Natalie Erin,-163,2007,36117
2985,2985,2923,2007-04-17 18:42:00,207.190.81.186,62,2007,36179
2986,2986,2922,2007-04-17 18:43:00,156.56.171.237,341,2007,36520
2987,2988,2920,2007-04-17 18:44:00,Dan East,-5,2007,36515
2988,2989,2919,2007-04-17 18:44:00,Fuzzykiwi,386,2007,36901
2989,2987,2921,2007-04-17 18:44:00,LinguistAtLarge,113,2007,37014
2990,2990,2915,2007-04-17 18:45:00,138.88.64.64,-17,2007,36997
2991,2991,2917,2007-04-17 18:45:00,68.239.65.186,0,2007,36997
2992,2992,2918,2007-04-17 18:45:00,138.88.64.64,-14,2007,36983
2993,2993,2916,2007-04-17 18:45:00,Mayorcheese,0,2007,36983
2994,2994,2914,2007-04-17 18:46:00,CaptainMike,-2,2007,36981
2995,2995,2913,2007-04-17 18:46:00,138.88.64.64,-4,2007,36977
2996,2996,2912,2007-04-17 18:46:00,Natalie Erin,-6,2007,36971
2997,2998,2910,2007-04-17 18:47:00,Natalie Erin,0,2007,36971
2998,2997,2911,2007-04-17 18:47:00,SouthernNights,0,2007,36971
2999,2999,2909,2007-04-17 18:47:00,Rdfox 76,23,2007,36994
3000,3000,2908,2007-04-17 18:48:00,Swatjester,97,2007,37091
3001,3001,2902,2007-04-17 18:49:00,67.186.17.133,0,2007,37091
3002,3002,2903,2007-04-17 18:49:00,LinguistAtLarge,68,2007,37159
3003,3003,2906,2007-04-17 18:49:00,Swatjester,94,2007,37253
3004,3004,2905,2007-04-17 18:49:00,Just Chilling,4,2007,37257
3005,3005,2907,2007-04-17 18:49:00,70.176.64.56,8,2007,37265
3006,3006,2904,2007-04-17 18:49:00,MiFeinberg,-432,2007,36833
3007,3009,2899,2007-04-17 18:50:00,SouthernNights,-78,2007,36755
3008,3010,2898,2007-04-17 18:50:00,162.129.44.86,11,2007,36766
3009,3007,2901,2007-04-17 18:50:00,Swatjester,78,2007,36844
3010,3008,2900,2007-04-17 18:50:00,Rdfox 76,0,2007,36844
3011,3014,2894,2007-04-17 18:51:00,Stevenscollege,0,2007,36844
3012,3013,2895,2007-04-17 18:51:00,Dynaflow,0,2007,36844
3013,3011,2897,2007-04-17 18:51:00,Jersey Devil,0,2007,36844
3014,3012,2896,2007-04-17 18:51:00,Rufus843,0,2007,36844
3015,3015,2893,2007-04-17 18:52:00,70.176.64.56,-8,2007,36836
3016,3016,2891,2007-04-17 18:53:00,Rufus843,64,2007,36900
3017,3017,2890,2007-04-17 18:53:00,SouthernNights,0,2007,36900
3018,3018,2892,2007-04-17 18:53:00,Dynaflow,8,2007,36908
3019,3019,2889,2007-04-17 18:54:00,Azudai45,0,2007,36908
3020,3020,2888,2007-04-17 18:54:00,JoanneB,0,2007,36908
3021,3022,2886,2007-04-17 18:55:00,Swatjester,66,2007,36974
3022,3021,2887,2007-04-17 18:55:00,198.209.80.253,28,2007,37002
3023,3023,2885,2007-04-17 18:55:00,Swatjester,62,2007,37064
3024,3024,2884,2007-04-17 18:55:00,Rufus843,2,2007,37066
3025,3025,2881,2007-04-17 18:56:00,82.171.6.98,-28,2007,37038
3026,3026,2883,2007-04-17 18:56:00,Azudai45,0,2007,37038
3027,3027,2882,2007-04-17 18:56:00,Swatjester,79,2007,37117
3028,3029,2880,2007-04-17 18:57:00,AgentCDE,0,2007,37117
3029,3030,2879,2007-04-17 18:57:00,MiFeinberg,-51,2007,37066
3030,3028,2877,2007-04-17 18:57:00,Valley2city,79,2007,37145
3031,3031,2878,2007-04-17 18:57:00,Chuck Sirloin,-28,2007,37117
3032,3037,2871,2007-04-17 18:58:00,66.251.1.226,0,2007,37117
3033,3035,2873,2007-04-17 18:58:00,24.30.71.89,0,2007,37117
3034,3036,2872,2007-04-17 18:58:00,JoanneB,0,2007,37117
3035,3033,2875,2007-04-17 18:58:00,Killintimeslowly,312,2007,37429
3036,3034,2874,2007-04-17 18:58:00,HappyCamper,-14,2007,37415
3037,3032,2876,2007-04-17 18:58:00,202.63.101.18,14,2007,37429
3038,3038,2866,2007-04-17 18:59:00,71.76.177.218,-3,2007,37426
3039,3039,2867,2007-04-17 18:59:00,Just Chilling,13,2007,37439
3040,3040,2868,2007-04-17 18:59:00,Coemgenus,-14,2007,37425
3041,3041,2869,2007-04-17 18:59:00,Killintimeslowly,71,2007,37496
3042,3042,2870,2007-04-17 18:59:00,Chuck Sirloin,-8,2007,37488
3043,3046,2862,2007-04-17 19:00:00,Swatjester,146,2007,37634
3044,3045,2863,2007-04-17 19:00:00,MKoltnow,4,2007,37638
3045,3043,2865,2007-04-17 19:00:00,Patricknoddy,3,2007,37641
3046,3044,2864,2007-04-17 19:00:00,Crump78,2,2007,37643
3047,3047,2856,2007-04-17 19:01:00,24.149.241.173,0,2007,37643
3048,3048,2858,2007-04-17 19:01:00,12.5.62.70,236,2007,37879
3049,3049,2855,2007-04-17 19:01:00,207.75.158.200,47,2007,37926
3050,3050,2857,2007-04-17 19:01:00,Creet,-22,2007,37904
3051,3051,2860,2007-04-17 19:01:00,66.251.1.226,0,2007,37904
3052,3052,2861,2007-04-17 19:01:00,24.207.42.24,191,2007,38095
3053,3053,2859,2007-04-17 19:01:00,Motor.on,-130,2007,37965
3054,3054,2854,2007-04-17 19:02:00,24.1.190.99,193,2007,38158
3055,3055,2853,2007-04-17 19:03:00,Rdfox 76,-193,2007,37965
3056,3058,2850,2007-04-17 19:04:00,Danaan,-390,2007,37575
3057,3056,2852,2007-04-17 19:04:00,Swatjester,0,2007,37575
3058,3057,2851,2007-04-17 19:04:00,Natalie Erin,0,2007,37575
3059,3059,2849,2007-04-17 19:05:00,Swatjester,268,2007,37843
3060,3060,2848,2007-04-17 19:05:00,TSim,492,2007,38335
3061,3061,2847,2007-04-17 19:05:00,Creet,21,2007,38356
3062,3062,2845,2007-04-17 19:06:00,Swatjester,-22,2007,38334
3063,3063,2846,2007-04-17 19:06:00,Swatjester,0,2007,38334
3064,3064,2844,2007-04-17 19:07:00,Killintimeslowly,164,2007,38498
3065,3065,2843,2007-04-17 19:07:00,TSim,-70,2007,38428
3066,3066,2842,2007-04-17 19:08:00,Natalie Erin,351,2007,38779
3067,3068,2840,2007-04-17 19:09:00,63.102.87.27,166,2007,38945
3068,3067,2841,2007-04-17 19:09:00,Lilkunta,-152,2007,38793
3069,3069,2839,2007-04-17 19:10:00,63.102.87.27,74,2007,38867
3070,3070,2838,2007-04-17 19:11:00,Zooomabooma,76,2007,38943
3071,3071,2837,2007-04-17 19:11:00,75.0.252.44,-1,2007,38942
3072,3072,2836,2007-04-17 19:11:00,63.102.87.27,-174,2007,38768
3073,3076,2835,2007-04-17 19:12:00,198.103.223.51,-304,2007,38464
3074,3075,2833,2007-04-17 19:12:00,165.234.184.28,182,2007,38646
3075,3077,2834,2007-04-17 19:12:00,Daveswagon,-4,2007,38642
3076,3073,2831,2007-04-17 19:12:00,Dynaflow,-65,2007,38577
3077,3074,2832,2007-04-17 19:12:00,Rdfox 76,304,2007,38881
3078,3079,2828,2007-04-17 19:13:00,128.143.52.248,1,2007,38882
3079,3080,2830,2007-04-17 19:13:00,Daveswagon,-3,2007,38879
3080,3078,2829,2007-04-17 19:13:00,Netscott,-8,2007,38871
3081,3081,2827,2007-04-17 19:14:00,Daveswagon,-111,2007,38760
3082,3082,2826,2007-04-17 19:14:00,TSim,26,2007,38786
3083,3083,2825,2007-04-17 19:14:00,63.102.87.27,74,2007,38860
3084,3084,2821,2007-04-17 19:15:00,MrCalifornia,-75,2007,38785
3085,3085,2820,2007-04-17 19:15:00,Killintimeslowly,94,2007,38879
3086,3086,2823,2007-04-17 19:15:00,Dynaflow,-161,2007,38718
3087,3087,2824,2007-04-17 19:15:00,HappyCamper,-73,2007,38645
3088,3088,2822,2007-04-17 19:15:00,Jdcooper,-9,2007,38636
3089,3091,2819,2007-04-17 19:17:00,Three ways round,-11,2007,38625
3090,3090,2817,2007-04-17 19:17:00,HeirToPendragon,0,2007,38625
3091,3089,2818,2007-04-17 19:17:00,TSim,-25,2007,38600
3092,3092,2816,2007-04-17 19:18:00,HappyCamper,9,2007,38609
3093,3093,2815,2007-04-17 19:18:00,Three ways round,7,2007,38616
3094,3094,2814,2007-04-17 19:19:00,HappyCamper,16,2007,38632
3095,3095,2813,2007-04-17 19:19:00,Block1of4,306,2007,38938
3096,3096,2812,2007-04-17 19:20:00,Killintimeslowly,37,2007,38975
3097,3097,2811,2007-04-17 19:20:00,156.99.14.161,16,2007,38991
3098,3098,2810,2007-04-17 19:20:00,Killintimeslowly,1,2007,38992
3099,3099,2807,2007-04-17 19:21:00,HappyCamper,4,2007,38996
3100,3100,2808,2007-04-17 19:21:00,Ximota,4,2007,39000
3101,3101,2809,2007-04-17 19:21:00,Blue Jeans91,10,2007,39010
3102,3103,2805,2007-04-17 19:22:00,Killintimeslowly,99,2007,39109
3103,3102,2806,2007-04-17 19:22:00,128.192.41.126,41,2007,39150
3104,3104,2804,2007-04-17 19:23:00,Xous,2,2007,39152
3105,3105,2803,2007-04-17 19:23:00,Coemgenus,1,2007,39153
3106,3106,2802,2007-04-17 19:23:00,68.72.80.217,252,2007,39405
3107,3107,2801,2007-04-17 19:23:00,Spencewah,-306,2007,39099
3108,3108,2800,2007-04-17 19:24:00,MoRsE,-8,2007,39091
3109,3109,2799,2007-04-17 19:24:00,66.165.31.200,1,2007,39092
3110,3112,2797,2007-04-17 19:25:00,Mercenary2k,-1,2007,39091
3111,3111,2798,2007-04-17 19:25:00,Mercenary2k,64,2007,39155
3112,3110,2796,2007-04-17 19:25:00,198.7.241.76,34,2007,39189
3113,3113,2795,2007-04-17 19:26:00,Thenthornthing,101,2007,39290
3114,3114,2794,2007-04-17 19:26:00,MoRsE,21,2007,39311
3115,3115,2793,2007-04-17 19:27:00,MoRsE,4,2007,39315
3116,3116,2792,2007-04-17 19:27:00,DJFrankie2468,1,2007,39316
3117,3117,2791,2007-04-17 19:27:00,Abe Lincoln,0,2007,39316
3118,3118,2790,2007-04-17 19:27:00,MoRsE,-4,2007,39312
3119,3120,2788,2007-04-17 19:28:00,HappyCamper,-51,2007,39261
3120,3121,2787,2007-04-17 19:28:00,Spencewah,0,2007,39261
3121,3119,2789,2007-04-17 19:28:00,68.48.163.37,-7,2007,39254
3122,3124,2785,2007-04-17 19:29:00,12.1.250.99,125,2007,39379
3123,3125,2784,2007-04-17 19:29:00,HappyCamper,-50,2007,39329
3124,3122,2783,2007-04-17 19:29:00,Rdfox 76,0,2007,39329
3125,3123,2786,2007-04-17 19:29:00,Balthazarduju,1,2007,39330
3126,3128,2782,2007-04-17 19:30:00,156.63.195.2,-5,2007,39325
3127,3129,2780,2007-04-17 19:30:00,Twitchism,0,2007,39325
3128,3126,2781,2007-04-17 19:30:00,Coemgenus,7,2007,39332
3129,3127,2779,2007-04-17 19:30:00,Arrowned,11,2007,39343
3130,3130,2778,2007-04-17 19:31:00,Rooot,0,2007,39343
3131,3131,2777,2007-04-17 19:31:00,DJFrankie2468,1,2007,39344
3132,3132,2776,2007-04-17 19:31:00,Arrowned,14,2007,39358
3133,3133,2775,2007-04-17 19:31:00,Twitchism,0,2007,39358
3134,3134,2774,2007-04-17 19:31:00,156.63.195.2,36,2007,39394
3135,3135,2773,2007-04-17 19:31:00,Coemgenus,0,2007,39394
3136,3136,2770,2007-04-17 19:32:00,89.213.14.198,368,2007,39762
3137,3137,2769,2007-04-17 19:32:00,Twitchism,0,2007,39762
3138,3138,2771,2007-04-17 19:32:00,Sina22,85,2007,39847
3139,3141,2766,2007-04-17 19:33:00,Twitchism,-340,2007,39507
3140,3140,2767,2007-04-17 19:33:00,69.140.0.33,-158,2007,39349
3141,3139,2768,2007-04-17 19:33:00,Coemgenus,-36,2007,39313
3142,3142,2765,2007-04-17 19:34:00,J. Finkelstein,-1,2007,39312
3143,3143,2764,2007-04-17 19:34:00,Ike9898,-10,2007,39302
3144,3144,2763,2007-04-17 19:34:00,Netscott,104,2007,39406
3145,3145,2762,2007-04-17 19:34:00,Ike9898,-368,2007,39038
3146,3146,2761,2007-04-17 19:34:00,74.110.88.181,-162,2007,38876
3147,3147,2759,2007-04-17 19:35:00,HappyCamper,24,2007,38900
3148,3148,2760,2007-04-17 19:35:00,Balthazarduju,-1,2007,38899
3149,3149,2758,2007-04-17 19:36:00,Efrafra,49,2007,38948
3150,3150,2757,2007-04-17 19:36:00,Lunkhead,24,2007,38972
3151,3154,2753,2007-04-17 19:37:00,Violask81976,0,2007,38972
3152,3153,2754,2007-04-17 19:37:00,Swaun,-371,2007,38601
3153,3152,2755,2007-04-17 19:37:00,El C,0,2007,38601
3154,3151,2756,2007-04-17 19:37:00,Natalie Erin,-24,2007,38577
3155,3155,2749,2007-04-17 19:38:00,Violask81976,-2,2007,38575
3156,3156,2748,2007-04-17 19:38:00,Mercenary2k,199,2007,38774
3157,3157,2751,2007-04-17 19:38:00,Violask81976,0,2007,38774
3158,3158,2752,2007-04-17 19:38:00,William Desby,61,2007,38835
3159,3159,2750,2007-04-17 19:38:00,SlimVirgin,-40,2007,38795
3160,3160,2747,2007-04-17 19:39:00,Mercenary2k,2,2007,38797
3161,3161,2746,2007-04-17 19:40:00,Mercenary2k,-1,2007,38796
3162,3162,2745,2007-04-17 19:40:00,"Hit bull, win steak",21,2007,38817
3163,3163,2744,2007-04-17 19:40:00,Kevinp2,413,2007,39230
3164,3164,2743,2007-04-17 19:40:00,SlimVirgin,-1,2007,39229
3165,3167,2740,2007-04-17 19:41:00,156.63.195.2,14,2007,39243
3166,3165,2742,2007-04-17 19:41:00,156.63.195.2,176,2007,39419
3167,3166,2741,2007-04-17 19:41:00,Lunkhead,1,2007,39420
3168,3168,2735,2007-04-17 19:42:00,HappyCamper,-25,2007,39395
3169,3169,2734,2007-04-17 19:42:00,Swaun,249,2007,39644
3170,3170,2737,2007-04-17 19:42:00,68.107.197.139,287,2007,39931
3171,3171,2738,2007-04-17 19:42:00,Block1of4,306,2007,40237
3172,3172,2736,2007-04-17 19:42:00,71.163.4.52,63,2007,40300
3173,3173,2739,2007-04-17 19:42:00,71.247.237.15,25,2007,40325
3174,3179,2728,2007-04-17 19:43:00,Netscott,10,2007,40335
3175,3180,2727,2007-04-17 19:43:00,156.63.195.2,43,2007,40378
3176,3178,2729,2007-04-17 19:43:00,Sulfiteboy,6,2007,40384
3177,3174,2733,2007-04-17 19:43:00,FunPika,-199,2007,40185
3178,3176,2731,2007-04-17 19:43:00,Flavourdan,0,2007,40185
3179,3177,2730,2007-04-17 19:43:00,Netscott,54,2007,40239
3180,3175,2732,2007-04-17 19:43:00,71.163.4.52,0,2007,40239
3181,3181,2723,2007-04-17 19:44:00,HeirToPendragon,0,2007,40239
3182,3182,2724,2007-04-17 19:44:00,Chrislk02,0,2007,40239
3183,3183,2726,2007-04-17 19:44:00,24.187.17.189,0,2007,40239
3184,3184,2725,2007-04-17 19:44:00,Coemgenus,-43,2007,40196
3185,3185,2722,2007-04-17 19:45:00,HappyCamper,0,2007,40196
3186,3189,2718,2007-04-17 19:46:00,Flavourdan,0,2007,40196
3187,3190,2717,2007-04-17 19:46:00,Violask81976,0,2007,40196
3188,3188,2719,2007-04-17 19:46:00,HeirToPendragon,0,2007,40196
3189,3187,2720,2007-04-17 19:46:00,HappyCamper,0,2007,40196
3190,3186,2721,2007-04-17 19:46:00,Bellhalla,8,2007,40204
3191,3191,2712,2007-04-17 19:47:00,Netscott,18,2007,40222
3192,3192,2713,2007-04-17 19:47:00,TSim,34,2007,40256
3193,3193,2715,2007-04-17 19:47:00,HeirToPendragon,0,2007,40256
3194,3194,2716,2007-04-17 19:47:00,Flavourdan,0,2007,40256
3195,3195,2714,2007-04-17 19:47:00,Crump78,-203,2007,40053
3196,3196,2711,2007-04-17 19:48:00,El C,-1,2007,40052
3197,3197,2710,2007-04-17 19:48:00,Flavourdan,0,2007,40052
3198,3201,2706,2007-04-17 19:49:00,Netscott,18,2007,40070
3199,3202,2705,2007-04-17 19:49:00,HeirToPendragon,0,2007,40070
3200,3199,2708,2007-04-17 19:49:00,Flavourdan,0,2007,40070
3201,3198,2709,2007-04-17 19:49:00,Violask81976,0,2007,40070
3202,3200,2707,2007-04-17 19:49:00,Coemgenus,-232,2007,39838
3203,3203,2704,2007-04-17 19:50:00,Swatjester,0,2007,39838
3204,3204,2703,2007-04-17 19:50:00,Jameswchen,68,2007,39906
3205,3205,2700,2007-04-17 19:51:00,Sherurcij,0,2007,39906
3206,3206,2702,2007-04-17 19:51:00,Rdfox 76,-232,2007,39674
3207,3207,2701,2007-04-17 19:51:00,HokieRNB,67,2007,39741
3208,3213,2694,2007-04-17 19:52:00,Kizor,-29,2007,39712
3209,3212,2695,2007-04-17 19:52:00,Swatjester,17,2007,39729
3210,3211,2696,2007-04-17 19:52:00,Ike9898,0,2007,39729
3211,3209,2698,2007-04-17 19:52:00,Swatjester,0,2007,39729
3212,3208,2699,2007-04-17 19:52:00,HokieRNB,-8,2007,39721
3213,3210,2697,2007-04-17 19:52:00,Jmlk17,0,2007,39721
3214,3214,2689,2007-04-17 19:53:00,Jmlk17,2,2007,39723
3215,3215,2690,2007-04-17 19:53:00,Jmlk17,11,2007,39734
3216,3216,2692,2007-04-17 19:53:00,SouthernNights,31,2007,39765
3217,3217,2693,2007-04-17 19:53:00,Chuck Sirloin,-22,2007,39743
3218,3218,2691,2007-04-17 19:53:00,Drjayphd,381,2007,40124
3219,3224,2688,2007-04-17 19:54:00,Hendo1769,167,2007,40291
3220,3223,2683,2007-04-17 19:54:00,Kizor,-1,2007,40290
3221,3222,2684,2007-04-17 19:54:00,Bogwink,224,2007,40514
3222,3220,2686,2007-04-17 19:54:00,Kizor,28,2007,40542
3223,3219,2687,2007-04-17 19:54:00,William Desby,32,2007,40574
3224,3221,2685,2007-04-17 19:54:00,Kevin Lakhani,-2,2007,40572
3225,3225,2682,2007-04-17 19:55:00,De Administrando Imperio,6,2007,40578
3226,3226,2681,2007-04-17 19:55:00,MoRsE,1,2007,40579
3227,3227,2680,2007-04-17 19:55:00,Jmlk17,-4,2007,40575
3228,3228,2679,2007-04-17 19:55:00,AceYYC,0,2007,40575
3229,3229,2678,2007-04-17 19:55:00,Neutrality,-27,2007,40548
3230,3230,2677,2007-04-17 19:55:00,Dynaflow,0,2007,40548
3231,3231,2676,2007-04-17 19:56:00,Quang188,152,2007,40700
3232,3232,2675,2007-04-17 19:56:00,William Desby,-11,2007,40689
3233,3234,2673,2007-04-17 19:57:00,HeirToPendragon,-13,2007,40676
3234,3233,2674,2007-04-17 19:57:00,SlimVirgin,-3,2007,40673
3235,3235,2672,2007-04-17 19:58:00,Lawikitejana,0,2007,40673
3236,3236,2671,2007-04-17 19:58:00,BobJones,24,2007,40697
3237,3237,2670,2007-04-17 19:58:00,Henry W. Schmitt,-5,2007,40692
3238,3238,2669,2007-04-17 19:59:00,BobJones,1,2007,40693
3239,3239,2668,2007-04-17 19:59:00,SlimVirgin,-13,2007,40680
3240,3240,2667,2007-04-17 19:59:00,Baccyak4H,8,2007,40688
3241,3243,2665,2007-04-17 20:00:00,Prodego,-4,2007,40684
3242,3241,2664,2007-04-17 20:00:00,Dynaflow,161,2007,40845
3243,3242,2666,2007-04-17 20:00:00,Tom from 8L,64,2007,40909
3244,3246,2661,2007-04-17 20:01:00,Burnt Flower,0,2007,40909
3245,3245,2662,2007-04-17 20:01:00,HappyCamper,2,2007,40911
3246,3244,2663,2007-04-17 20:01:00,Orudie,79,2007,40990
3247,3247,2660,2007-04-17 20:02:00,HappyCamper,53,2007,41043
3248,3248,2659,2007-04-17 20:02:00,Imjustmatthew,82,2007,41125
3249,3249,2658,2007-04-17 20:03:00,Violask81976,-77,2007,41048
3250,3250,2657,2007-04-17 20:03:00,Mratzloff,-28,2007,41020
3251,3251,2656,2007-04-17 20:03:00,Lawikitejana,38,2007,41058
3252,3252,2653,2007-04-17 20:04:00,Maelnuneb,1,2007,41059
3253,3253,2654,2007-04-17 20:04:00,Baccyak4H,0,2007,41059
3254,3254,2655,2007-04-17 20:04:00,HappyCamper,-50,2007,41009
3255,3255,2652,2007-04-17 20:05:00,Mratzloff,-5,2007,41004
3256,3260,2647,2007-04-17 20:06:00,Mratzloff,-10,2007,40994
3257,3259,2648,2007-04-17 20:06:00,Mercenary2k,0,2007,40994
3258,3256,2651,2007-04-17 20:06:00,Mratzloff,0,2007,40994
3259,3257,2650,2007-04-17 20:06:00,Lawikitejana,177,2007,41171
3260,3258,2649,2007-04-17 20:06:00,Diamantina,19,2007,41190
3261,3261,2646,2007-04-17 20:07:00,HappyCamper,92,2007,41282
3262,3262,2643,2007-04-17 20:09:00,Rdfox 76,-10,2007,41272
3263,3263,2642,2007-04-17 20:09:00,Mratzloff,0,2007,41272
3264,3264,2644,2007-04-17 20:09:00,HappyCamper,97,2007,41369
3265,3265,2645,2007-04-17 20:09:00,Mratzloff,4,2007,41373
3266,3268,2640,2007-04-17 20:10:00,Nilay.khandelwal,-1,2007,41372
3267,3267,2641,2007-04-17 20:10:00,Mratzloff,2,2007,41374
3268,3266,2639,2007-04-17 20:10:00,SlimVirgin,0,2007,41374
3269,3269,2638,2007-04-17 20:11:00,SlimVirgin,0,2007,41374
3270,3270,2637,2007-04-17 20:11:00,Lawikitejana,151,2007,41525
3271,3271,2636,2007-04-17 20:11:00,Jacoplane,27,2007,41552
3272,3272,2635,2007-04-17 20:12:00,Jacoplane,0,2007,41552
3273,3273,2634,2007-04-17 20:12:00,Mratzloff,-4,2007,41548
3274,3274,2633,2007-04-17 20:12:00,Waffleninja,364,2007,41912
3275,3275,2632,2007-04-17 20:13:00,HappyCamper,5,2007,41917
3276,3278,2631,2007-04-17 20:14:00,Mratzloff,-1,2007,41916
3277,3276,2629,2007-04-17 20:14:00,HappyCamper,0,2007,41916
3278,3277,2630,2007-04-17 20:14:00,Lawikitejana,128,2007,42044
3279,3279,2628,2007-04-17 20:15:00,Jacoplane,28,2007,42072
3280,3280,2627,2007-04-17 20:15:00,HokieRNB,0,2007,42072
3281,3284,2623,2007-04-17 20:16:00,Nilay.khandelwal,-32,2007,42040
3282,3281,2626,2007-04-17 20:16:00,HokieRNB,-82,2007,41958
3283,3282,2625,2007-04-17 20:16:00,Dynaflow,0,2007,41958
3284,3283,2624,2007-04-17 20:16:00,Lawikitejana,0,2007,41958
3285,3285,2622,2007-04-17 20:16:00,Nyttend,-4,2007,41954
3286,3290,2621,2007-04-17 20:17:00,Three ways round,-2,2007,41952
3287,3291,2619,2007-04-17 20:17:00,SlimVirgin,2,2007,41954
3288,3289,2620,2007-04-17 20:17:00,SlimVirgin,0,2007,41954
3289,3288,2618,2007-04-17 20:17:00,Npatwari,24,2007,41978
3290,3287,2616,2007-04-17 20:17:00,SouthernNights,-1,2007,41977
3291,3286,2617,2007-04-17 20:17:00,SouthernNights,177,2007,42154
3292,3292,2615,2007-04-17 20:18:00,HappyCamper,-194,2007,41960
3293,3293,2614,2007-04-17 20:18:00,Mratzloff,-31,2007,41929
3294,3294,2613,2007-04-17 20:18:00,SouthernNights,0,2007,41929
3295,3295,2612,2007-04-17 20:19:00,Violask81976,-2,2007,41927
3296,3296,2611,2007-04-17 20:19:00,SouthernNights,1,2007,41928
3297,3297,2610,2007-04-17 20:19:00,Mratzloff,-1,2007,41927
3298,3299,2608,2007-04-18 00:00:00,202.89.146.173,51,2007,41978
3299,3298,2609,2007-04-18 00:00:00,Dzhnmaster,47,2007,42025
3300,3300,2604,2007-04-18 00:01:00,Mercenary2k,387,2007,42412
3301,3301,2606,2007-04-18 00:01:00,Tim Q. Wells,-91,2007,42321
3302,3302,2607,2007-04-18 00:01:00,76.3.158.174,91,2007,42412
3303,3303,2605,2007-04-18 00:01:00,JB82,-51,2007,42361
3304,3308,2599,2007-04-18 00:02:00,Tejas81,279,2007,42640
3305,3304,2603,2007-04-18 00:02:00,202.89.146.173,89,2007,42729
3306,3305,2602,2007-04-18 00:02:00,67.10.82.225,88,2007,42817
3307,3306,2601,2007-04-18 00:02:00,Sad mouse,27,2007,42844
3308,3307,2600,2007-04-18 00:02:00,The Placebo Effect,55,2007,42899
3309,3309,2598,2007-04-18 00:02:00,Chunky Rice,-366,2007,42533
3310,3315,2595,2007-04-18 00:03:00,76.80.210.38,15,2007,42548
3311,3316,2597,2007-04-18 00:03:00,Doodoobutter,49,2007,42597
3312,3314,2596,2007-04-18 00:03:00,67.10.82.225,2,2007,42599
3313,3312,2593,2007-04-18 00:03:00,Inoculatedcities,-3,2007,42596
3314,3313,2594,2007-04-18 00:03:00,66.162.41.118,4,2007,42600
3315,3311,2592,2007-04-18 00:03:00,67.10.82.225,4,2007,42604
3316,3310,2591,2007-04-18 00:03:00,Chunky Rice,-403,2007,42201
3317,3317,2586,2007-04-18 00:04:00,Downwards,4,2007,42205
3318,3318,2587,2007-04-18 00:04:00,Natalie Erin,-1,2007,42204
3319,3319,2590,2007-04-18 00:04:00,Rooot,0,2007,42204
3320,3320,2589,2007-04-18 00:04:00,67.10.82.225,-9,2007,42195
3321,3321,2588,2007-04-18 00:04:00,Tejas81,5,2007,42200
3322,3324,2583,2007-04-18 00:05:00,RoyBoy,-1,2007,42199
3323,3323,2584,2007-04-18 00:05:00,Flamebroil,-106,2007,42093
3324,3322,2585,2007-04-18 00:05:00,RoyBoy,-6,2007,42087
3325,3325,2582,2007-04-18 00:06:00,65.189.129.140,0,2007,42087
3326,3326,2581,2007-04-18 00:06:00,75.61.197.250,65,2007,42152
3327,3327,2580,2007-04-18 00:06:00,RoyBoy,-5,2007,42147
3328,3328,2579,2007-04-18 00:07:00,Natalie Erin,1,2007,42148
3329,3329,2578,2007-04-18 00:07:00,24.107.66.62,57,2007,42205
3330,3330,2576,2007-04-18 00:08:00,RoyBoy,1,2007,42206
3331,3331,2575,2007-04-18 00:08:00,24.46.46.77,149,2007,42355
3332,3332,2577,2007-04-18 00:08:00,Natalie Erin,-66,2007,42289
3333,3335,2571,2007-04-18 00:09:00,Enohpxesther,1,2007,42290
3334,3334,2572,2007-04-18 00:09:00,66.162.41.118,-74,2007,42216
3335,3333,2573,2007-04-18 00:09:00,Enohpxesther,131,2007,42347
3336,3336,2567,2007-04-18 00:10:00,71.79.207.218,1,2007,42348
3337,3337,2566,2007-04-18 00:10:00,152.3.46.147,0,2007,42348
3338,3338,2568,2007-04-18 00:10:00,75.61.197.250,-65,2007,42283
3339,3339,2570,2007-04-18 00:10:00,Kntrabssi,-57,2007,42226
3340,3340,2569,2007-04-18 00:10:00,71.79.207.218,42,2007,42268
3341,3341,2565,2007-04-18 00:11:00,Rooot,0,2007,42268
3342,3342,2564,2007-04-18 00:12:00,Enohpxesther,-132,2007,42136
3343,3343,2563,2007-04-18 00:13:00,Chunky Rice,-12,2007,42124
3344,3344,2562,2007-04-18 00:13:00,Mercenary2k,140,2007,42264
3345,3346,2560,2007-04-18 00:14:00,Natalie Erin,0,2007,42264
3346,3345,2561,2007-04-18 00:14:00,Jlesage,22,2007,42286
3347,3347,2559,2007-04-18 00:15:00,Natalie Erin,-43,2007,42243
3348,3348,2555,2007-04-18 00:16:00,64.59.144.85,40,2007,42283
3349,3349,2558,2007-04-18 00:16:00,75.73.94.20,-1,2007,42282
3350,3350,2557,2007-04-18 00:16:00,Evolt,-3,2007,42279
3351,3351,2556,2007-04-18 00:16:00,Uthbrian,351,2007,42630
3352,3352,2554,2007-04-18 00:17:00,75.57.153.122,1,2007,42631
3353,3353,2553,2007-04-18 00:17:00,12.201.86.40,0,2007,42631
3354,3357,2549,2007-04-18 00:18:00,Uthbrian,16,2007,42647
3355,3356,2550,2007-04-18 00:18:00,219.111.79.38,83,2007,42730
3356,3358,2548,2007-04-18 00:18:00,208.124.56.13,0,2007,42730
3357,3354,2552,2007-04-18 00:18:00,Arvash,150,2007,42880
3358,3355,2551,2007-04-18 00:18:00,12.201.86.40,0,2007,42880
3359,3359,2544,2007-04-18 00:19:00,Natalie Erin,-83,2007,42797
3360,3360,2543,2007-04-18 00:19:00,Arvash,2,2007,42799
3361,3361,2545,2007-04-18 00:19:00,Gdo01,0,2007,42799
3362,3362,2547,2007-04-18 00:19:00,Luna Santin,0,2007,42799
3363,3363,2546,2007-04-18 00:19:00,Swatjester,0,2007,42799
3364,3369,2537,2007-04-18 00:20:00,Natalie Erin,-45,2007,42754
3365,3368,2538,2007-04-18 00:20:00,Just Chilling,-1,2007,42753
3366,3367,2539,2007-04-18 00:20:00,Swatjester,0,2007,42753
3367,3365,2541,2007-04-18 00:20:00,Just Chilling,0,2007,42753
3368,3364,2542,2007-04-18 00:20:00,Kntrabssi,-19,2007,42734
3369,3366,2540,2007-04-18 00:20:00,Ghlobe,-1,2007,42733
3370,3370,2536,2007-04-18 00:21:00,Natalie Erin,1,2007,42734
3371,3371,2535,2007-04-18 00:21:00,24.20.69.240,-125,2007,42609
3372,3372,2534,2007-04-18 00:21:00,Rdfox 76,-16,2007,42593
3373,3377,2533,2007-04-18 00:22:00,Swatjester,266,2007,42859
3374,3373,2529,2007-04-18 00:22:00,67.83.128.225,-169,2007,42690
3375,3374,2530,2007-04-18 00:22:00,MoRsE,18,2007,42708
3376,3375,2531,2007-04-18 00:22:00,Rooot,0,2007,42708
3377,3376,2532,2007-04-18 00:22:00,BorgQueen,12,2007,42720
3378,3378,2528,2007-04-18 00:23:00,Natalie Erin,169,2007,42889
3379,3380,2526,2007-04-18 00:24:00,24.20.82.115,5,2007,42894
3380,3379,2527,2007-04-18 00:24:00,Topatientlyexplain,-4,2007,42890
3381,3381,2525,2007-04-18 00:25:00,MoRsE,43,2007,42933
3382,3382,2524,2007-04-18 00:25:00,Swatjester,0,2007,42933
3383,3383,2523,2007-04-18 00:25:00,Rawrthness,11,2007,42944
3384,3391,2522,2007-04-18 00:26:00,Swatjester,-5,2007,42939
3385,3392,2518,2007-04-18 00:26:00,Evil Monkey,8,2007,42947
3386,3389,2519,2007-04-18 00:26:00,RichardWeiss,45,2007,42992
3387,3388,2521,2007-04-18 00:26:00,Hdt83,0,2007,42992
3388,3390,2520,2007-04-18 00:26:00,Tango,1,2007,42993
3389,3386,2516,2007-04-18 00:26:00,71.108.148.178,272,2007,43265
3390,3385,2515,2007-04-18 00:26:00,Just Chilling,0,2007,43265
3391,3384,2514,2007-04-18 00:26:00,Rdfox 76,99,2007,43364
3392,3387,2517,2007-04-18 00:26:00,MoRsE,19,2007,43383
3393,3393,2513,2007-04-18 00:27:00,71.108.148.178,0,2007,43383
3394,3394,2512,2007-04-18 00:27:00,Zytron,85,2007,43468
3395,3395,2511,2007-04-18 00:27:00,Rooot,0,2007,43468
3396,3400,2510,2007-04-18 00:28:00,71.108.148.178,-53,2007,43415
3397,3396,2505,2007-04-18 00:28:00,Tim Q. Wells,-21,2007,43394
3398,3397,2506,2007-04-18 00:28:00,RichardWeiss,1,2007,43395
3399,3398,2507,2007-04-18 00:28:00,MoRsE,19,2007,43414
3400,3399,2509,2007-04-18 00:28:00,Rawrthness,2,2007,43416
3401,3401,2508,2007-04-18 00:28:00,76.189.141.148,-1,2007,43415
3402,3406,2500,2007-04-18 00:29:00,BorgQueen,0,2007,43415
3403,3405,2501,2007-04-18 00:29:00,RichardWeiss,4,2007,43419
3404,3404,2502,2007-04-18 00:29:00,65.189.129.140,0,2007,43419
3405,3403,2503,2007-04-18 00:29:00,Rawrthness,4,2007,43423
3406,3402,2504,2007-04-18 00:29:00,FlyingLeopard2014,72,2007,43495
3407,3407,2496,2007-04-18 00:30:00,Cherylyoung,140,2007,43635
3408,3408,2499,2007-04-18 00:30:00,BorgQueen,-4,2007,43631
3409,3409,2498,2007-04-18 00:30:00,Natalie Erin,-3,2007,43628
3410,3410,2497,2007-04-18 00:30:00,Evolt,-18,2007,43610
3411,3411,2494,2007-04-18 00:31:00,BorgQueen,13,2007,43623
3412,3412,2495,2007-04-18 00:31:00,Johnpseudo,1,2007,43624
3413,3413,2493,2007-04-18 00:31:00,Natalie Erin,24,2007,43648
3414,3415,2491,2007-04-18 00:32:00,Hdt83,9,2007,43657
3415,3414,2492,2007-04-18 00:32:00,Jakedaniel,-200,2007,43457
3416,3416,2490,2007-04-18 00:33:00,Hdt83,200,2007,43657
3417,3417,2489,2007-04-18 00:33:00,RebelAt,4,2007,43661
3418,3418,2488,2007-04-18 00:33:00,Tim Q. Wells,0,2007,43661
3419,3419,2487,2007-04-18 00:34:00,Itsgeneb,1,2007,43662
3420,3420,2486,2007-04-18 00:34:00,Kntrabssi,-200,2007,43462
3421,3421,2485,2007-04-18 00:34:00,MoRsE,65,2007,43527
3422,3422,2484,2007-04-18 00:36:00,BorgQueen,0,2007,43527
3423,3423,2483,2007-04-18 00:36:00,DannyBoy7783,0,2007,43527
3424,3425,2482,2007-04-18 00:37:00,G4rce,1,2007,43528
3425,3424,2481,2007-04-18 00:37:00,TheLeopard,0,2007,43528
3426,3427,2479,2007-04-18 00:38:00,Cherylyoung,208,2007,43736
3427,3426,2480,2007-04-18 00:38:00,Dcandeto,-73,2007,43663
3428,3428,2478,2007-04-18 00:39:00,Spoon!,4,2007,43667
3429,3429,2477,2007-04-18 00:39:00,Magmafox,1,2007,43668
3430,3430,2476,2007-04-18 00:39:00,Karrmann,-6,2007,43662
3431,3431,2475,2007-04-18 00:41:00,MoRsE,-288,2007,43374
3432,3432,2474,2007-04-18 00:41:00,Cherylyoung,0,2007,43374
3433,3433,2473,2007-04-18 00:41:00,Swatjester,0,2007,43374
3434,3434,2471,2007-04-18 00:42:00,TheLeopard,-1,2007,43373
3435,3435,2472,2007-04-18 00:42:00,Bufsabres2007,37,2007,43410
3436,3436,2470,2007-04-18 00:43:00,Y2kcrazyjoker4,1,2007,43411
3437,3439,2469,2007-04-18 00:44:00,Jdcooper,0,2007,43411
3438,3437,2468,2007-04-18 00:44:00,Karrmann,100,2007,43511
3439,3438,2467,2007-04-18 00:44:00,Y2kcrazyjoker4,2,2007,43513
3440,3440,2466,2007-04-18 00:45:00,BorgQueen,0,2007,43513
3441,3441,2465,2007-04-18 00:45:00,ColeMan6595,1,2007,43514
3442,3442,2464,2007-04-18 00:45:00,BorgQueen,-1,2007,43513
3443,3443,2463,2007-04-18 00:45:00,Karrmann,89,2007,43602
3444,3446,2461,2007-04-18 00:49:00,Gbms86,23,2007,43625
3445,3444,2459,2007-04-18 00:49:00,Karrmann,11,2007,43636
3446,3445,2462,2007-04-18 00:49:00,Karrmann,0,2007,43636
3447,3447,2460,2007-04-18 00:49:00,CanadianCaesar,-6,2007,43630
3448,3449,2457,2007-04-18 00:50:00,Swatjester,255,2007,43885
3449,3448,2458,2007-04-18 00:50:00,SouthernNights,13,2007,43898
3450,3450,2456,2007-04-18 00:51:00,Chubberi,15,2007,43913
3451,3451,2455,2007-04-18 00:51:00,Karrmann,20,2007,43933
3452,3452,2454,2007-04-18 00:52:00,Halosniper5,-74,2007,43859
3453,3453,2453,2007-04-18 00:54:00,DES2928,284,2007,44143
3454,3454,2452,2007-04-18 00:54:00,Mithent,-13,2007,44130
3455,3455,2449,2007-04-18 00:55:00,Karrmann,-6,2007,44124
3456,3456,2450,2007-04-18 00:55:00,Mithent,-2,2007,44122
3457,3457,2451,2007-04-18 00:55:00,Karrmann,6,2007,44128
3458,3459,2447,2007-04-18 00:57:00,Swatjester,390,2007,44518
3459,3458,2448,2007-04-18 00:57:00,B,113,2007,44631
3460,3460,2446,2007-04-18 00:58:00,Cpoupart,79,2007,44710
3461,3461,2445,2007-04-18 00:58:00,DES2928,41,2007,44751
3462,3462,2444,2007-04-18 00:59:00,Rdfox 76,-79,2007,44672
3463,3463,2443,2007-04-18 00:59:00,DES2928,13,2007,44685
3464,3464,2442,2007-04-18 01:00:00,Bufsabres2007,79,2007,44764
3465,3465,2441,2007-04-18 01:00:00,SouthernNights,49,2007,44813
3466,3466,2438,2007-04-18 01:01:00,Swatjester,191,2007,45004
3467,3467,2440,2007-04-18 01:01:00,RattleMan,-38,2007,44966
3468,3468,2439,2007-04-18 01:01:00,Bufsabres2007,-79,2007,44887
3469,3469,2437,2007-04-18 01:02:00,Fvasconcellos,2,2007,44889
3470,3470,2436,2007-04-18 01:02:00,B,4,2007,44893
3471,3471,2435,2007-04-18 01:06:00,Wittylama,16,2007,44909
3472,3472,2434,2007-04-18 01:07:00,DXRAW,89,2007,44998
3473,3473,2433,2007-04-18 01:09:00,Arbustoo,0,2007,44998
3474,3474,2432,2007-04-18 01:12:00,Rdfox 76,0,2007,44998
3475,3475,2431,2007-04-18 01:14:00,AstroHurricane001,18,2007,45016
3476,3476,2428,2007-04-18 01:15:00,B,-2,2007,45014
3477,3477,2427,2007-04-18 01:15:00,Pimemorizer,0,2007,45014
3478,3478,2430,2007-04-18 01:15:00,SouthernNights,-14,2007,45000
3479,3479,2429,2007-04-18 01:15:00,HeirToPendragon,-4,2007,44996
3480,3482,2424,2007-04-18 01:17:00,Sox23,11,2007,45007
3481,3481,2425,2007-04-18 01:17:00,SouthernNights,-167,2007,44840
3482,3480,2426,2007-04-18 01:17:00,Swatjester,464,2007,45304
3483,3483,2423,2007-04-18 01:18:00,SouthernNights,-171,2007,45133
3484,3484,2422,2007-04-18 01:18:00,Swatjester,58,2007,45191
3485,3485,2421,2007-04-18 01:19:00,Swatjester,-2,2007,45189
3486,3486,2420,2007-04-18 01:20:00,SouthernNights,-14,2007,45175
3487,3487,2419,2007-04-18 01:20:00,Retired username,194,2007,45369
3488,3488,2418,2007-04-18 01:22:00,Flamebroil,340,2007,45709
3489,3489,2417,2007-04-18 01:22:00,Efrafra,-490,2007,45219
3490,3490,2416,2007-04-18 01:23:00,Efrafra,-10,2007,45209
3491,3491,2415,2007-04-18 01:23:00,Retired username,1,2007,45210
3492,3493,2413,2007-04-18 01:24:00,SouthernNights,499,2007,45709
3493,3492,2414,2007-04-18 01:24:00,RisingStar,30,2007,45739
3494,3494,2412,2007-04-18 01:24:00,RisingStar,2,2007,45741
3495,3496,2410,2007-04-18 01:25:00,Mikethegreen,8,2007,45749
3496,3495,2411,2007-04-18 01:25:00,SouthernNights,0,2007,45749
3497,3497,2409,2007-04-18 01:26:00,Retired username,0,2007,45749
3498,3498,2408,2007-04-18 01:26:00,Retired username,1,2007,45750
3499,3499,2407,2007-04-18 01:27:00,Penwhale,-59,2007,45691
3500,3500,2406,2007-04-18 01:28:00,The Dover Demon,1,2007,45692
3501,3501,2403,2007-04-18 01:32:00,Gdo01,207,2007,45899
3502,3502,2405,2007-04-18 01:32:00,Xasthuresque,24,2007,45923
3503,3503,2404,2007-04-18 01:32:00,Rdfox 76,-231,2007,45692
3504,3505,2402,2007-04-18 01:33:00,Tux256ac,-65,2007,45627
3505,3504,2401,2007-04-18 01:33:00,Sl91607,244,2007,45871
3506,3506,2399,2007-04-18 01:34:00,Kardrak,53,2007,45924
3507,3507,2400,2007-04-18 01:34:00,MiFeinberg,245,2007,46169
3508,3508,2398,2007-04-18 01:35:00,Swatjester,0,2007,46169
3509,3509,2397,2007-04-18 01:36:00,Swatjester,-3,2007,46166
3510,3510,2396,2007-04-18 01:37:00,Slo-mo,4,2007,46170
3511,3511,2395,2007-04-18 01:37:00,Xasthuresque,-35,2007,46135
3512,3514,2392,2007-04-18 01:38:00,MiFeinberg,7,2007,46142
3513,3512,2394,2007-04-18 01:38:00,Swatjester,14,2007,46156
3514,3513,2393,2007-04-18 01:38:00,Rukiddingme?,-19,2007,46137
3515,3516,2390,2007-04-18 01:39:00,Rukiddingme?,-42,2007,46095
3516,3517,2391,2007-04-18 01:39:00,Swatjester,59,2007,46154
3517,3515,2389,2007-04-18 01:39:00,Retired username,-58,2007,46096
3518,3518,2388,2007-04-18 01:40:00,Retired username,16,2007,46112
3519,3519,2387,2007-04-18 01:42:00,Sl91607,-6,2007,46106
3520,3520,2386,2007-04-18 01:42:00,Evil Monkey,0,2007,46106
3521,3521,2385,2007-04-18 01:43:00,Mikethegreen,303,2007,46409
3522,3522,2384,2007-04-18 01:43:00,ScottyWZ,1,2007,46410
3523,3523,2383,2007-04-18 01:43:00,Evil Monkey,0,2007,46410
3524,3524,2382,2007-04-18 01:44:00,Rukiddingme?,-30,2007,46380
3525,3525,2381,2007-04-18 01:46:00,Osman A,218,2007,46598
3526,3527,2380,2007-04-18 01:47:00,Frozenpandaman,51,2007,46649
3527,3526,2379,2007-04-18 01:47:00,Johntex,20,2007,46669
3528,3528,2375,2007-04-18 01:49:00,Gdo01,0,2007,46669
3529,3529,2378,2007-04-18 01:49:00,Frozenpandaman,0,2007,46669
3530,3530,2377,2007-04-18 01:49:00,MartinBot,0,2007,46669
3531,3531,2374,2007-04-18 01:50:00,Rufus843,0,2007,46669
3532,3532,2373,2007-04-18 01:50:00,Efrafra,482,2007,47151
3533,3533,2372,2007-04-18 01:50:00,B,183,2007,47334
3534,3534,2371,2007-04-18 01:51:00,Rukiddingme?,-45,2007,47289
3535,3535,2370,2007-04-18 01:56:00,Phaedriel,268,2007,47557
3536,3536,2369,2007-04-18 02:00:00,"Hit bull, win steak",408,2007,47965
3537,3537,2366,2007-04-18 02:02:00,OatmealSmith,69,2007,48034
3538,3538,2368,2007-04-18 02:02:00,Chensiyuan,-1,2007,48033
3539,3539,2365,2007-04-18 02:03:00,Chensiyuan,-2,2007,48031
3540,3540,2364,2007-04-18 02:04:00,Chensiyuan,3,2007,48034
3541,3541,2363,2007-04-18 02:07:00,Evil Monkey,6,2007,48040
3542,3542,2362,2007-04-18 02:10:00,Paul Richter,-74,2007,47966
3543,3543,2361,2007-04-18 02:10:00,Silent SAM,-132,2007,47834
3544,3544,2360,2007-04-18 02:11:00,AceYYC,10,2007,47844
3545,3545,2359,2007-04-18 02:12:00,Uthbrian,4,2007,47848
3546,3546,2358,2007-04-18 02:13:00,Ranma9617,4,2007,47852
3547,3547,2357,2007-04-18 02:14:00,Dinomite,0,2007,47852
3548,3548,2356,2007-04-18 02:15:00,Nandesuka,1,2007,47853
3549,3549,2355,2007-04-18 02:15:00,Mercenary2k,0,2007,47853
3550,3550,2354,2007-04-18 02:16:00,Stephen,0,2007,47853
3551,3551,2353,2007-04-18 02:17:00,Dinomite,-2,2007,47851
3552,3552,2352,2007-04-18 02:18:00,Dinomite,1,2007,47852
3553,3553,2351,2007-04-18 02:19:00,Quadratic,-1,2007,47851
3554,3554,2350,2007-04-18 02:19:00,Dinomite,-1,2007,47850
3555,3555,2349,2007-04-18 02:21:00,Donatelo20012000,78,2007,47928
3556,3556,2348,2007-04-18 02:21:00,Zuejay,418,2007,48346
3557,3557,2347,2007-04-18 02:21:00,B,101,2007,48447
3558,3558,2346,2007-04-18 02:22:00,Che829,4,2007,48451
3559,3559,2345,2007-04-18 02:24:00,Mercenary2k,0,2007,48451
3560,3560,2344,2007-04-18 02:25:00,Kntrabssi,193,2007,48644
3561,3561,2343,2007-04-18 02:27:00,Donatelo20012000,122,2007,48766
3562,3562,2341,2007-04-18 02:29:00,Just Chilling,2,2007,48768
3563,3563,2342,2007-04-18 02:29:00,Just Chilling,-20,2007,48748
3564,3564,2340,2007-04-18 02:30:00,Lancedance,-4,2007,48744
3565,3565,2339,2007-04-18 02:31:00,THF,23,2007,48767
3566,3566,2338,2007-04-18 02:31:00,Kntrabssi,-19,2007,48748
3567,3567,2337,2007-04-18 02:32:00,Que-Can,-43,2007,48705
3568,3568,2336,2007-04-18 02:32:00,Lancedance,24,2007,48729
3569,3574,2333,2007-04-18 02:33:00,Evil Monkey,-71,2007,48658
3570,3573,2335,2007-04-18 02:33:00,Kntrabssi,-24,2007,48634
3571,3572,2334,2007-04-18 02:33:00,TK-134,3,2007,48637
3572,3570,2330,2007-04-18 02:33:00,Coemgenus,2,2007,48639
3573,3569,2329,2007-04-18 02:33:00,Donatelo20012000,4,2007,48643
3574,3571,2331,2007-04-18 02:33:00,Lancedance,4,2007,48647
3575,3575,2328,2007-04-18 02:34:00,Just Chilling,8,2007,48655
3576,3576,2327,2007-04-18 02:34:00,HappyCamper,25,2007,48680
3577,3577,2326,2007-04-18 02:34:00,Lancedance,-1,2007,48679
3578,3578,2325,2007-04-18 02:35:00,Articunobird55,125,2007,48804
3579,3579,2324,2007-04-18 02:35:00,Kntrabssi,-124,2007,48680
3580,3580,2323,2007-04-18 02:35:00,Evil Monkey,201,2007,48881
3581,3581,2322,2007-04-18 02:36:00,The Letter J,19,2007,48900
3582,3585,2319,2007-04-18 02:37:00,The Letter J,-19,2007,48881
3583,3584,2321,2007-04-18 02:37:00,Kntrabssi,-4,2007,48877
3584,3583,2320,2007-04-18 02:37:00,TK-134,0,2007,48877
3585,3582,2318,2007-04-18 02:37:00,Kntrabssi,1,2007,48878
3586,3586,2317,2007-04-18 02:38:00,President David Palmer,0,2007,48878
3587,3587,2316,2007-04-18 02:39:00,Markm62,-5,2007,48873
3588,3588,2315,2007-04-18 02:40:00,Thehoagster07,117,2007,48990
3589,3589,2314,2007-04-18 02:40:00,Wordbuilder,-26,2007,48964
3590,3590,2313,2007-04-18 02:43:00,Mercenary2k,0,2007,48964
3591,3591,2312,2007-04-18 02:44:00,Markm62,49,2007,49013
3592,3592,2311,2007-04-18 02:44:00,Mercenary2k,227,2007,49240
3593,3595,2310,2007-04-18 02:45:00,Kntrabssi,150,2007,49390
3594,3594,2309,2007-04-18 02:45:00,Mary8,-5,2007,49385
3595,3593,2308,2007-04-18 02:45:00,Nyttend,-1,2007,49384
3596,3596,2307,2007-04-18 02:46:00,Dan East,3,2007,49387
3597,3597,2306,2007-04-18 02:47:00,Halo,-361,2007,49026
3598,3598,2305,2007-04-18 02:49:00,Mary8,221,2007,49247
3599,3599,2303,2007-04-18 02:50:00,Dan East,25,2007,49272
3600,3600,2304,2007-04-18 02:50:00,Mary8,-1,2007,49271
3601,3601,2302,2007-04-18 02:50:00,Kalmia,14,2007,49285
3602,3602,2301,2007-04-18 02:52:00,Niubrad,4,2007,49289
3603,3603,2300,2007-04-18 02:52:00,Spangineer,1,2007,49290
3604,3607,2297,2007-04-18 02:53:00,Markm62,48,2007,49338
3605,3606,2298,2007-04-18 02:53:00,Spangineer,0,2007,49338
3606,3604,2296,2007-04-18 02:53:00,Dan East,-5,2007,49333
3607,3605,2299,2007-04-18 02:53:00,Yaf,361,2007,49694
3608,3608,2295,2007-04-18 02:54:00,Spangineer,1,2007,49695
3609,3609,2294,2007-04-18 02:56:00,Spangineer,1,2007,49696
3610,3610,2293,2007-04-18 02:57:00,Spangineer,-2,2007,49694
3611,3611,2292,2007-04-18 02:57:00,Halo,-361,2007,49333
3612,3612,2291,2007-04-18 02:58:00,Bluefield,-44,2007,49289
3613,3613,2290,2007-04-18 02:59:00,Bluefield,-281,2007,49008
3614,3615,2288,2007-04-18 03:00:00,Kntrabssi,0,2007,49008
3615,3614,2289,2007-04-18 03:00:00,Spangineer,-1,2007,49007
3616,3618,2286,2007-04-18 03:01:00,Kntrabssi,0,2007,49007
3617,3617,2287,2007-04-18 03:01:00,Spangineer,1,2007,49008
3618,3616,2285,2007-04-18 03:01:00,B,171,2007,49179
3619,3619,2284,2007-04-18 03:02:00,Spangineer,-1,2007,49178
3620,3620,2283,2007-04-18 03:04:00,Tymothy,110,2007,49288
3621,3621,2282,2007-04-18 03:05:00,Markm62,1,2007,49289
3622,3622,2281,2007-04-18 03:05:00,Evil Monkey,130,2007,49419
3623,3624,2278,2007-04-18 03:06:00,Dan East,69,2007,49488
3624,3623,2277,2007-04-18 03:06:00,Markm62,-14,2007,49474
3625,3625,2279,2007-04-18 03:06:00,Spangineer,10,2007,49484
3626,3627,2275,2007-04-18 03:08:00,Markm62,6,2007,49490
3627,3626,2276,2007-04-18 03:08:00,Spangineer,-2,2007,49488
3628,3630,2272,2007-04-18 03:09:00,BorgQueen,-16,2007,49472
3629,3628,2274,2007-04-18 03:09:00,BorgQueen,0,2007,49472
3630,3629,2273,2007-04-18 03:09:00,Markm62,-4,2007,49468
3631,3631,2271,2007-04-18 03:10:00,Rdfox 76,-120,2007,49348
3632,3632,2270,2007-04-18 03:10:00,Markm62,14,2007,49362
3633,3633,2269,2007-04-18 03:13:00,Kntrabssi,-111,2007,49251
3634,3634,2268,2007-04-18 03:14:00,Markm62,30,2007,49281
3635,3635,2267,2007-04-18 03:15:00,Markm62,7,2007,49288
3636,3636,2264,2007-04-18 03:16:00,Joeblack999,87,2007,49375
3637,3637,2265,2007-04-18 03:16:00,Mickyg9,-61,2007,49314
3638,3638,2266,2007-04-18 03:16:00,Spanish lullaby,61,2007,49375
3639,3641,2261,2007-04-18 03:17:00,Jrockley,-13,2007,49362
3640,3639,2263,2007-04-18 03:17:00,137.154.16.30,342,2007,49704
3641,3640,2262,2007-04-18 03:17:00,Markm62,17,2007,49721
3642,3642,2260,2007-04-18 03:18:00,Zenohockey,2,2007,49723
3643,3643,2259,2007-04-18 03:18:00,Markm62,7,2007,49730
3644,3644,2258,2007-04-18 03:18:00,150.108.235.22,-87,2007,49643
3645,3645,2257,2007-04-18 03:19:00,Dan East,-1,2007,49642
3646,3646,2255,2007-04-18 03:20:00,69.143.246.239,13,2007,49655
3647,3647,2256,2007-04-18 03:20:00,Flavourdan,-2,2007,49653
3648,3648,2254,2007-04-18 03:21:00,Markm62,1,2007,49654
3649,3649,2253,2007-04-18 03:21:00,Killintimeslowly,260,2007,49914
3650,3650,2252,2007-04-18 03:22:00,Markm62,1,2007,49915
3651,3651,2251,2007-04-18 03:23:00,Markm62,1,2007,49916
3652,3652,2250,2007-04-18 03:24:00,65.92.214.200,0,2007,49916
3653,3653,2249,2007-04-18 03:25:00,71.99.4.13,-2,2007,49914
3654,3654,2248,2007-04-18 03:26:00,65.92.214.200,0,2007,49914
3655,3655,2247,2007-04-18 03:27:00,71.99.4.13,1,2007,49915
3656,3656,2246,2007-04-18 03:27:00,66.75.233.156,57,2007,49972
3657,3657,2245,2007-04-18 03:28:00,Mllefantine,0,2007,49972
3658,3658,2244,2007-04-18 03:28:00,LinguistAtLarge,-63,2007,49909
3659,3661,2242,2007-04-18 03:29:00,137.154.16.31,0,2007,49909
3660,3659,2241,2007-04-18 03:29:00,66.201.172.192,0,2007,49909
3661,3660,2243,2007-04-18 03:29:00,Mllefantine,-2,2007,49907
3662,3662,2240,2007-04-18 03:30:00,MartinBot,0,2007,49907
3663,3663,2239,2007-04-18 03:30:00,71.159.158.198,67,2007,49974
3664,3664,2238,2007-04-18 03:30:00,Uthbrian,84,2007,50058
3665,3665,2237,2007-04-18 03:32:00,LinguistAtLarge,181,2007,50239
3666,3666,2236,2007-04-18 03:32:00,O^O,-56,2007,50183
3667,3667,2235,2007-04-18 03:34:00,Zenohockey,6,2007,50189
3668,3668,2234,2007-04-18 03:34:00,LinguistAtLarge,29,2007,50218
3669,3669,2233,2007-04-18 03:35:00,Natalie Erin,0,2007,50218
3670,3670,2232,2007-04-18 03:36:00,Hbdragon88,-150,2007,50068
3671,3672,2231,2007-04-18 03:37:00,Arsonal,378,2007,50446
3672,3671,2230,2007-04-18 03:37:00,Mytwocents,24,2007,50470
3673,3673,2229,2007-04-18 03:37:00,Zenohockey,1,2007,50471
3674,3674,2228,2007-04-18 03:38:00,Dynaflow,-49,2007,50422
3675,3675,2227,2007-04-18 03:38:00,Dirtysocks,-4,2007,50418
3676,3677,2225,2007-04-18 03:39:00,24.68.251.3,8,2007,50426
3677,3676,2226,2007-04-18 03:39:00,Dynaflow,-7,2007,50419
3678,3680,2222,2007-04-18 03:40:00,Arsonal,26,2007,50445
3679,3678,2224,2007-04-18 03:40:00,Zenohockey,1,2007,50446
3680,3679,2223,2007-04-18 03:40:00,Gmaxwell,-243,2007,50203
3681,3681,2221,2007-04-18 03:41:00,Halo,-113,2007,50090
3682,3682,2217,2007-04-18 03:42:00,Gmaxwell,36,2007,50126
3683,3683,2219,2007-04-18 03:42:00,GeneralShamu,57,2007,50183
3684,3684,2218,2007-04-18 03:42:00,Halo,-20,2007,50163
3685,3685,2220,2007-04-18 03:42:00,Uthbrian,-1,2007,50162
3686,3686,2216,2007-04-18 03:43:00,Zenohockey,19,2007,50181
3687,3687,2215,2007-04-18 03:43:00,GeneralShamu,4,2007,50185
3688,3688,2214,2007-04-18 03:44:00,GeneralShamu,0,2007,50185
3689,3691,2211,2007-04-18 03:45:00,Arsonal,1,2007,50186
3690,3690,2212,2007-04-18 03:45:00,24.109.94.208,35,2007,50221
3691,3689,2213,2007-04-18 03:45:00,Arsonal,0,2007,50221
3692,3692,2210,2007-04-18 03:46:00,Dynaflow,-35,2007,50186
3693,3693,2209,2007-04-18 03:47:00,HokieRNB,0,2007,50186
3694,3694,2207,2007-04-18 03:48:00,Ashkani,-54,2007,50132
3695,3695,2208,2007-04-18 03:48:00,ElKevbo,-22,2007,50110
3696,3696,2205,2007-04-18 03:49:00,Halo,35,2007,50145
3697,3697,2206,2007-04-18 03:49:00,ElKevbo,-1,2007,50144
3698,3698,2203,2007-04-18 03:50:00,ElKevbo,0,2007,50144
3699,3699,2201,2007-04-18 03:50:00,ElKevbo,-1,2007,50143
3700,3700,2204,2007-04-18 03:50:00,Halo,1,2007,50144
3701,3701,2202,2007-04-18 03:50:00,KnowledgeOfSelf,-67,2007,50077
3702,3703,2199,2007-04-18 03:51:00,76.176.76.193,261,2007,50338
3703,3702,2200,2007-04-18 03:51:00,68.50.188.115,0,2007,50338
3704,3704,2198,2007-04-18 03:52:00,ElKevbo,-31,2007,50307
3705,3705,2197,2007-04-18 03:55:00,72.93.82.138,-61,2007,50246
3706,3706,2196,2007-04-18 03:55:00,66.68.63.11,412,2007,50658
3707,3707,2195,2007-04-18 03:56:00,64.229.8.182,162,2007,50820
3708,3708,2192,2007-04-18 03:57:00,24.55.188.112,361,2007,51181
3709,3709,2194,2007-04-18 03:57:00,Halo,1,2007,51182
3710,3710,2193,2007-04-18 03:57:00,Halo,-1,2007,51181
3711,3711,2191,2007-04-18 03:58:00,Uthbrian,-261,2007,50920
3712,3712,2190,2007-04-18 03:58:00,67.188.80.65,-162,2007,50758
3713,3713,2189,2007-04-18 03:59:00,Halo,0,2007,50758
3714,3714,2188,2007-04-18 04:01:00,B,136,2007,50894
3715,3715,2187,2007-04-18 04:03:00,Halo,-3,2007,50891
3716,3716,2186,2007-04-18 04:04:00,Cue the Strings,-19,2007,50872
3717,3717,2185,2007-04-18 04:05:00,198.82.118.164,266,2007,51138
3718,3718,2184,2007-04-18 04:06:00,AceYYC,1,2007,51139
3719,3719,2183,2007-04-18 04:08:00,Wafulz,-73,2007,51066
3720,3720,2181,2007-04-18 04:11:00,Crosshair~enwiki,0,2007,51066
3721,3721,2182,2007-04-18 04:11:00,68.40.119.213,15,2007,51081
3722,3722,2179,2007-04-18 04:12:00,ElKevbo,-1,2007,51080
3723,3723,2178,2007-04-18 04:12:00,Evil Monkey,0,2007,51080
3724,3724,2180,2007-04-18 04:12:00,69.86.136.255,-1,2007,51079
3725,3729,2173,2007-04-18 04:13:00,ElKevbo,-3,2007,51076
3726,3728,2174,2007-04-18 04:13:00,165.228.1.15,-15,2007,51061
3727,3725,2177,2007-04-18 04:13:00,Tiens,48,2007,51109
3728,3726,2176,2007-04-18 04:13:00,71.131.215.20,0,2007,51109
3729,3727,2175,2007-04-18 04:13:00,70.162.57.225,4,2007,51113
3730,3730,2171,2007-04-18 04:14:00,Halo,14,2007,51127
3731,3731,2172,2007-04-18 04:14:00,ElKevbo,1,2007,51128
3732,3732,2169,2007-04-18 04:15:00,199.111.195.20,0,2007,51128
3733,3733,2168,2007-04-18 04:15:00,199.111.195.20,-15,2007,51113
3734,3734,2170,2007-04-18 04:15:00,Tejas81,468,2007,51581
3735,3735,2167,2007-04-18 04:16:00,Crosshair~enwiki,-8,2007,51573
3736,3736,2166,2007-04-18 04:16:00,Mickyg9,119,2007,51692
3737,3737,2165,2007-04-18 04:16:00,Halo,0,2007,51692
3738,3738,2164,2007-04-18 04:17:00,Crosshair~enwiki,-4,2007,51688
3739,3739,2163,2007-04-18 04:18:00,ElKevbo,88,2007,51776
3740,3740,2162,2007-04-18 04:18:00,Tejas81,1,2007,51777
3741,3741,2159,2007-04-18 04:19:00,Natalie Erin,-7,2007,51770
3742,3742,2160,2007-04-18 04:19:00,ElKevbo,1,2007,51771
3743,3743,2161,2007-04-18 04:19:00,Natalie Erin,-71,2007,51700
3744,3744,2158,2007-04-18 04:20:00,ElKevbo,9,2007,51709
3745,3745,2157,2007-04-18 04:20:00,ElKevbo,-12,2007,51697
3746,3746,2156,2007-04-18 04:21:00,74.105.34.183,7,2007,51704
3747,3747,2155,2007-04-18 04:21:00,Natalie Erin,-7,2007,51697
3748,3748,2154,2007-04-18 04:22:00,66.45.152.134,0,2007,51697
3749,3749,2153,2007-04-18 04:23:00,Fran Rogers,0,2007,51697
3750,3750,2152,2007-04-18 04:24:00,Mikethegreen,43,2007,51740
3751,3751,2151,2007-04-18 04:24:00,68.33.37.190,96,2007,51836
3752,3752,2150,2007-04-18 04:26:00,Halo,-95,2007,51741
3753,3753,2149,2007-04-18 04:27:00,69.15.16.178,114,2007,51855
3754,3754,2148,2007-04-18 04:28:00,Halo,-114,2007,51741
3755,3755,2147,2007-04-18 04:29:00,144.136.165.215,48,2007,51789
3756,3756,2145,2007-04-18 04:30:00,Halo,0,2007,51789
3757,3757,2146,2007-04-18 04:30:00,Uthbrian,0,2007,51789
3758,3761,2141,2007-04-18 04:31:00,Evil Monkey,8,2007,51797
3759,3760,2142,2007-04-18 04:31:00,Nomadtales,35,2007,51832
3760,3758,2144,2007-04-18 04:31:00,Mwaldrep,-48,2007,51784
3761,3759,2143,2007-04-18 04:31:00,Halo,4,2007,51788
3762,3762,2140,2007-04-18 04:34:00,Zencohen,4,2007,51792
3763,3763,2139,2007-04-18 04:34:00,Adam Brink,24,2007,51816
3764,3764,2138,2007-04-18 04:36:00,128.252.232.113,297,2007,52113
3765,3765,2136,2007-04-18 04:37:00,128.252.232.113,12,2007,52125
3766,3766,2137,2007-04-18 04:37:00,202.63.57.142,0,2007,52125
3767,3769,2134,2007-04-18 04:38:00,Halo,2,2007,52127
3768,3767,2133,2007-04-18 04:38:00,Halo,-2,2007,52125
3769,3768,2135,2007-04-18 04:38:00,Primalchaos,4,2007,52129
3770,3770,2132,2007-04-18 04:39:00,125.198.36.167,4,2007,52133
3771,3771,2131,2007-04-18 04:41:00,67.81.98.217,19,2007,52152
3772,3772,2130,2007-04-18 04:42:00,60.241.46.233,9,2007,52161
3773,3773,2129,2007-04-18 04:42:00,71.139.37.225,487,2007,52648
3774,3774,2128,2007-04-18 04:44:00,Mickyg9,184,2007,52832
3775,3775,2127,2007-04-18 04:46:00,71.139.37.225,374,2007,53206
3776,3776,2126,2007-04-18 04:46:00,Modernman007,7,2007,53213
3777,3777,2125,2007-04-18 04:47:00,66.117.144.189,0,2007,53213
3778,3778,2123,2007-04-18 04:48:00,Modernman007,-7,2007,53206
3779,3779,2124,2007-04-18 04:48:00,Dynaflow,0,2007,53206
3780,3780,2122,2007-04-18 04:49:00,Arsonal,-14,2007,53192
3781,3781,2121,2007-04-18 04:50:00,Dynaflow,-5,2007,53187
3782,3784,2118,2007-04-18 04:51:00,Modernman007,-17,2007,53170
3783,3782,2120,2007-04-18 04:51:00,Dynaflow,-7,2007,53163
3784,3783,2119,2007-04-18 04:51:00,Evil Monkey,-11,2007,53152
3785,3785,2117,2007-04-18 04:52:00,Halo,6,2007,53158
3786,3786,2113,2007-04-18 04:53:00,131.247.2.185,57,2007,53215
3787,3787,2114,2007-04-18 04:53:00,Dynaflow,328,2007,53543
3788,3788,2116,2007-04-18 04:53:00,131.247.2.185,78,2007,53621
3789,3789,2115,2007-04-18 04:53:00,70.80.97.213,-4,2007,53617
3790,3791,2112,2007-04-18 04:54:00,131.247.2.185,-1,2007,53616
3791,3790,2111,2007-04-18 04:54:00,Halo,-134,2007,53482
3792,3792,2110,2007-04-18 04:55:00,Dynaflow,-7,2007,53475
3793,3793,2109,2007-04-18 04:56:00,Dynaflow,14,2007,53489
3794,3794,2107,2007-04-18 04:58:00,Dynaflow,10,2007,53499
3795,3795,2108,2007-04-18 04:58:00,Pjharveynirvana,0,2007,53499
3796,3796,2106,2007-04-18 04:58:00,Pjharveynirvana,-1,2007,53498
3797,3797,2105,2007-04-18 04:59:00,Dynaflow,14,2007,53512
3798,3798,2104,2007-04-18 04:59:00,GreaterK,192,2007,53704
3799,3799,2103,2007-04-18 05:00:00,Iceberg007,0,2007,53704
3800,3800,2102,2007-04-18 05:00:00,Dynaflow,18,2007,53722
3801,3801,2101,2007-04-18 05:01:00,Dynaflow,-14,2007,53708
3802,3802,2100,2007-04-18 05:02:00,Halo,-192,2007,53516
3803,3803,2099,2007-04-18 05:03:00,Lillyrose,82,2007,53598
3804,3804,2098,2007-04-18 05:04:00,Renamed user ixgysjijel,-87,2007,53511
3805,3805,2096,2007-04-18 05:05:00,Rooot,0,2007,53511
3806,3806,2097,2007-04-18 05:05:00,80.43.97.216,-1,2007,53510
3807,3807,2095,2007-04-18 05:07:00,Halo,0,2007,53510
3808,3808,2094,2007-04-18 05:08:00,Yeatesy,-1,2007,53509
3809,3809,2093,2007-04-18 05:09:00,204.111.158.100,59,2007,53568
3810,3810,2092,2007-04-18 05:10:00,204.111.158.100,2,2007,53570
3811,3811,2091,2007-04-18 05:11:00,Iceberg007,32,2007,53602
3812,3812,2090,2007-04-18 05:12:00,Existitem,43,2007,53645
3813,3813,2088,2007-04-18 05:13:00,Iceberg007,1,2007,53646
3814,3814,2089,2007-04-18 05:13:00,Ryulong,-43,2007,53603
3815,3815,2087,2007-04-18 05:16:00,Halo,-114,2007,53489
3816,3817,2086,2007-04-18 05:20:00,151.203.190.88,50,2007,53539
3817,3816,2085,2007-04-18 05:20:00,Cmcnicoll,0,2007,53539
3818,3818,2084,2007-04-18 05:21:00,Dhartung,54,2007,53593
3819,3819,2083,2007-04-18 05:25:00,76.195.38.108,1,2007,53594
3820,3820,2082,2007-04-18 05:26:00,JustADude,-1,2007,53593
3821,3821,2081,2007-04-18 05:28:00,Halo,0,2007,53593
3822,3822,2080,2007-04-18 05:29:00,141.211.120.203,91,2007,53684
3823,3823,2079,2007-04-18 05:30:00,Lach Graham,395,2007,54079
3824,3824,2076,2007-04-18 05:33:00,69.226.236.47,89,2007,54168
3825,3825,2078,2007-04-18 05:33:00,BrOnXbOmBr21,0,2007,54168
3826,3826,2077,2007-04-18 05:33:00,71.61.88.66,-4,2007,54164
3827,3827,2075,2007-04-18 05:34:00,Chrishmt0423,0,2007,54164
3828,3828,2074,2007-04-18 05:35:00,Aksi great,4,2007,54168
3829,3829,2073,2007-04-18 05:35:00,Halo,8,2007,54176
3830,3830,2072,2007-04-18 05:37:00,207.5.192.56,31,2007,54207
3831,3831,2071,2007-04-18 05:38:00,Halo,-31,2007,54176
3832,3832,2070,2007-04-18 05:39:00,Raines,0,2007,54176
3833,3833,2069,2007-04-18 05:42:00,207.5.192.56,22,2007,54198
3834,3834,2068,2007-04-18 05:43:00,Runnerupnj,-1,2007,54197
3835,3835,2067,2007-04-18 05:43:00,Halo,-21,2007,54176
3836,3836,2065,2007-04-18 05:44:00,Sleepvivid~enwiki,33,2007,54209
3837,3837,2066,2007-04-18 05:44:00,Chrishmt0423,-42,2007,54167
3838,3839,2063,2007-04-18 05:46:00,SchuminWeb,10,2007,54177
3839,3838,2064,2007-04-18 05:46:00,Runnerupnj,-1,2007,54176
3840,3840,2062,2007-04-18 05:48:00,Sleepvivid~enwiki,29,2007,54205
3841,3841,2060,2007-04-18 05:49:00,Gerbrant,-39,2007,54166
3842,3842,2061,2007-04-18 05:49:00,Runnerupnj,-1,2007,54165
3843,3843,2059,2007-04-18 05:50:00,67.99.36.174,-2,2007,54163
3844,3844,2058,2007-04-18 05:50:00,Gerbrant,7,2007,54170
3845,3845,2057,2007-04-18 05:50:00,72.178.48.155,61,2007,54231
3846,3849,2056,2007-04-18 05:51:00,Kintetsubuffalo,0,2007,54231
3847,3848,2055,2007-04-18 05:51:00,Luna Santin,-29,2007,54202
3848,3850,2054,2007-04-18 05:51:00,Gerbrant,8,2007,54210
3849,3846,2053,2007-04-18 05:51:00,72.178.48.155,87,2007,54297
3850,3847,2052,2007-04-18 05:51:00,Mickyg9,44,2007,54341
3851,3851,2050,2007-04-18 05:52:00,MartinBot,-28,2007,54313
3852,3852,2051,2007-04-18 05:52:00,72.199.49.155,28,2007,54341
3853,3853,2049,2007-04-18 05:53:00,Halo,154,2007,54495
3854,3854,2048,2007-04-18 05:53:00,Kintetsubuffalo,-87,2007,54408
3855,3855,2047,2007-04-18 05:54:00,Gerbrant,-8,2007,54400
3856,3856,2046,2007-04-18 05:54:00,Luna Santin,-83,2007,54317
3857,3857,2045,2007-04-18 05:54:00,Halo,21,2007,54338
3858,3859,2044,2007-04-18 05:55:00,Gerbrant,57,2007,54395
3859,3858,2042,2007-04-18 05:55:00,Tonyrocks922,-368,2007,54027
3860,3860,2043,2007-04-18 05:55:00,Halo,1,2007,54028
3861,3861,2040,2007-04-18 05:57:00,72.178.48.155,279,2007,54307
3862,3862,2041,2007-04-18 05:57:00,Gerbrant,7,2007,54314
3863,3863,2039,2007-04-18 05:59:00,Gerbrant,0,2007,54314
3864,3864,2037,2007-04-18 06:00:00,Luna Santin,-279,2007,54035
3865,3865,2038,2007-04-18 06:00:00,Gerbrant,29,2007,54064
3866,3866,2036,2007-04-18 06:01:00,MrCalifornia,0,2007,54064
3867,3867,2035,2007-04-18 06:02:00,MrCalifornia,0,2007,54064
3868,3868,2034,2007-04-18 06:02:00,Gerbrant,42,2007,54106
3869,3869,2033,2007-04-18 06:03:00,Thenthornthing,9,2007,54115
3870,3870,2032,2007-04-18 06:03:00,Gerbrant,-22,2007,54093
3871,3871,2031,2007-04-18 06:04:00,Luna Santin,-16,2007,54077
3872,3874,2029,2007-04-18 06:05:00,72.178.48.155,286,2007,54363
3873,3873,2030,2007-04-18 06:05:00,Halo,0,2007,54363
3874,3872,2028,2007-04-18 06:05:00,Skimmilkred,5,2007,54368
3875,3875,2027,2007-04-18 06:06:00,Jasongao,-2,2007,54366
3876,3876,2026,2007-04-18 06:06:00,Tim Parenti,8,2007,54374
3877,3877,2025,2007-04-18 06:07:00,12.196.95.179,0,2007,54374
3878,3878,2024,2007-04-18 06:07:00,Turnipsnare,-1,2007,54373
3879,3879,2023,2007-04-18 06:08:00,SlimVirgin,1,2007,54374
3880,3880,2022,2007-04-18 06:08:00,Flavourdan,0,2007,54374
3881,3881,2021,2007-04-18 06:08:00,Luna Santin,0,2007,54374
3882,3882,2020,2007-04-18 06:08:00,SlimVirgin,0,2007,54374
3883,3885,2019,2007-04-18 06:09:00,Gerbrant,12,2007,54386
3884,3886,2017,2007-04-18 06:09:00,Luna Santin,-12,2007,54374
3885,3883,2016,2007-04-18 06:09:00,72.178.48.155,160,2007,54534
3886,3884,2018,2007-04-18 06:09:00,24.208.190.43,12,2007,54546
3887,3887,2015,2007-04-18 06:10:00,Flavourdan,0,2007,54546
3888,3888,2011,2007-04-18 06:11:00,72.178.48.155,69,2007,54615
3889,3889,2014,2007-04-18 06:11:00,Halo,0,2007,54615
3890,3890,2013,2007-04-18 06:11:00,Gerbrant,4,2007,54619
3891,3891,2012,2007-04-18 06:11:00,Thenthornthing,16,2007,54635
3892,3892,2010,2007-04-18 06:12:00,Halo,-5,2007,54630
3893,3893,2009,2007-04-18 06:12:00,Flavourdan,0,2007,54630
3894,3894,2008,2007-04-18 06:13:00,Halo,-16,2007,54614
3895,3895,2007,2007-04-18 06:13:00,66.45.152.134,138,2007,54752
3896,3896,2006,2007-04-18 06:13:00,Gerbrant,16,2007,54768
3897,3897,2005,2007-04-18 06:14:00,198.82.29.251,1,2007,54769
3898,3898,2002,2007-04-18 06:15:00,Renamed user ixgysjijel,383,2007,55152
3899,3899,2004,2007-04-18 06:15:00,Gerbrant,102,2007,55254
3900,3900,2003,2007-04-18 06:15:00,Halo,-138,2007,55116
3901,3901,2001,2007-04-18 06:16:00,Halo,0,2007,55116
3902,3902,2000,2007-04-18 06:17:00,Thenthornthing,6,2007,55122
3903,3903,1999,2007-04-18 06:17:00,Thenthornthing,167,2007,55289
3904,3904,1998,2007-04-18 06:17:00,69.227.18.194,-6,2007,55283
3905,3905,1996,2007-04-18 06:18:00,Gerbrant,34,2007,55317
3906,3906,1997,2007-04-18 06:18:00,70.22.4.12,0,2007,55317
3907,3907,1994,2007-04-18 06:19:00,128.54.240.251,118,2007,55435
3908,3908,1995,2007-04-18 06:19:00,12.74.207.251,-138,2007,55297
3909,3910,1992,2007-04-18 06:20:00,Luna Santin,0,2007,55297
3910,3909,1993,2007-04-18 06:20:00,66.45.152.134,-13,2007,55284
3911,3911,1991,2007-04-18 06:21:00,Luna Santin,6,2007,55290
3912,3912,1990,2007-04-18 06:21:00,Gerbrant,36,2007,55326
3913,3913,1989,2007-04-18 06:21:00,66.45.152.134,0,2007,55326
3914,3914,1988,2007-04-18 06:21:00,RattleMan,2,2007,55328
3915,3915,1987,2007-04-18 06:21:00,Luna Santin,15,2007,55343
3916,3916,1986,2007-04-18 06:22:00,Janejellyroll,0,2007,55343
3917,3917,1985,2007-04-18 06:22:00,Gerbrant,-4,2007,55339
3918,3918,1984,2007-04-18 06:23:00,RattleMan,2,2007,55341
3919,3919,1983,2007-04-18 06:25:00,24.235.255.208,0,2007,55341
3920,3921,1982,2007-04-18 06:28:00,Alison,0,2007,55341
3921,3920,1981,2007-04-18 06:28:00,12.217.128.130,21,2007,55362
3922,3922,1980,2007-04-18 06:29:00,Thenthornthing,-21,2007,55341
3923,3923,1979,2007-04-18 06:29:00,24.83.0.212,0,2007,55341
3924,3924,1978,2007-04-18 06:30:00,Halo,0,2007,55341
3925,3925,1977,2007-04-18 06:31:00,Geoff,-251,2007,55090
3926,3926,1976,2007-04-18 06:32:00,76.202.59.116,35,2007,55125
3927,3927,1975,2007-04-18 06:32:00,The undertow,-35,2007,55090
3928,3928,1974,2007-04-18 06:34:00,76.202.59.116,-262,2007,54828
3929,3929,1973,2007-04-18 06:36:00,Xuxunette,12,2007,54840
3930,3930,1972,2007-04-18 06:37:00,Thenthornthing,-251,2007,54589
3931,3931,1971,2007-04-18 06:38:00,Halo,-2,2007,54587
3932,3932,1970,2007-04-18 06:40:00,Xuxunette,-30,2007,54557
3933,3933,1969,2007-04-18 06:44:00,70.41.111.24,258,2007,54815
3934,3934,1967,2007-04-18 06:46:00,193.188.105.227,13,2007,54828
3935,3935,1968,2007-04-18 06:46:00,70.41.111.24,39,2007,54867
3936,3936,1966,2007-04-18 06:47:00,Halo,10,2007,54877
3937,3937,1965,2007-04-18 06:48:00,Halo,-8,2007,54869
3938,3938,1964,2007-04-18 06:52:00,69.235.250.183,12,2007,54881
3939,3939,1963,2007-04-18 06:53:00,69.235.250.183,-12,2007,54869
3940,3940,1962,2007-04-18 06:55:00,72.78.219.159,20,2007,54889
3941,3941,1961,2007-04-18 06:56:00,122.203.71.66,0,2007,54889
3942,3943,1960,2007-04-18 06:59:00,72.78.219.159,1,2007,54890
3943,3944,1959,2007-04-18 06:59:00,WhisperToMe,0,2007,54890
3944,3942,1958,2007-04-18 06:59:00,Chobot,-53,2007,54837
3945,3945,1956,2007-04-18 07:01:00,124.187.157.157,78,2007,54915
3946,3946,1955,2007-04-18 07:01:00,Halo,-78,2007,54837
3947,3947,1957,2007-04-18 07:01:00,Halo,0,2007,54837
3948,3948,1954,2007-04-18 07:02:00,168.103.55.32,13,2007,54850
3949,3949,1953,2007-04-18 07:03:00,Luna Santin,-13,2007,54837
3950,3950,1952,2007-04-18 07:04:00,219.90.189.105,0,2007,54837
3951,3951,1951,2007-04-18 07:04:00,Tdadamemd,10,2007,54847
3952,3954,1949,2007-04-18 07:05:00,68.99.188.115,54,2007,54901
3953,3952,1948,2007-04-18 07:05:00,65.54.155.48,-290,2007,54611
3954,3953,1950,2007-04-18 07:05:00,130.130.37.13,-59,2007,54552
3955,3956,1946,2007-04-18 07:06:00,Halo,-310,2007,54242
3956,3955,1947,2007-04-18 07:06:00,Pitel,-113,2007,54129
3957,3957,1945,2007-04-18 07:07:00,Halo,10,2007,54139
3958,3958,1944,2007-04-18 07:07:00,68.99.188.115,44,2007,54183
3959,3959,1943,2007-04-18 07:08:00,Luna Santin,-44,2007,54139
3960,3960,1942,2007-04-18 07:08:00,24.183.50.11,-10,2007,54129
3961,3961,1941,2007-04-18 07:11:00,68.3.20.55,10,2007,54139
3962,3962,1940,2007-04-18 07:12:00,Renamed user ixgysjijel,382,2007,54521
3963,3963,1939,2007-04-18 07:12:00,Neuros,0,2007,54521
3964,3964,1938,2007-04-18 07:15:00,Msiegler,-61,2007,54460
3965,3965,1937,2007-04-18 07:16:00,Monkeyblue,-45,2007,54415
3966,3966,1936,2007-04-18 07:17:00,67.168.54.28,68,2007,54483
3967,3967,1935,2007-04-18 07:20:00,Halo,-68,2007,54415
3968,3968,1933,2007-04-18 07:21:00,203.49.58.70,1,2007,54416
3969,3969,1934,2007-04-18 07:21:00,24.16.67.165,31,2007,54447
3970,3970,1932,2007-04-18 07:22:00,Luna Santin,-31,2007,54416
3971,3971,1931,2007-04-18 07:23:00,Logophile,46,2007,54462
3972,3972,1930,2007-04-18 07:23:00,Truflip99,121,2007,54583
3973,3973,1929,2007-04-18 07:23:00,Renamed user ixgysjijel,0,2007,54583
3974,3974,1928,2007-04-18 07:25:00,Truflip99,71,2007,54654
3975,3975,1927,2007-04-18 07:25:00,125.239.232.161,-32,2007,54622
3976,3976,1926,2007-04-18 07:25:00,Luna Santin,32,2007,54654
3977,3979,1924,2007-04-18 07:26:00,219.112.73.209,1,2007,54655
3978,3978,1925,2007-04-18 07:26:00,Abe Lincoln,-4,2007,54651
3979,3977,1923,2007-04-18 07:26:00,Narkstraws,0,2007,54651
3980,3980,1921,2007-04-18 07:27:00,Narkstraws,-174,2007,54477
3981,3981,1922,2007-04-18 07:27:00,MoRsE,25,2007,54502
3982,3982,1920,2007-04-18 07:27:00,Luna Santin,-1,2007,54501
3983,3983,1919,2007-04-18 07:28:00,Sleepvivid~enwiki,130,2007,54631
3984,3984,1918,2007-04-18 07:29:00,RoyBatty42,78,2007,54709
3985,3985,1917,2007-04-18 07:31:00,198.166.252.78,141,2007,54850
3986,3986,1916,2007-04-18 07:31:00,Abe Lincoln,4,2007,54854
3987,3987,1915,2007-04-18 07:33:00,153.110.45.14,-141,2007,54713
3988,3988,1914,2007-04-18 07:34:00,Something Original,-21,2007,54692
3989,3991,1911,2007-04-18 07:37:00,Something Original,21,2007,54713
3990,3989,1913,2007-04-18 07:37:00,Renamed user ixgysjijel,14,2007,54727
3991,3990,1912,2007-04-18 07:37:00,213.23.184.98,63,2007,54790
3992,3992,1910,2007-04-18 07:38:00,Logophile,24,2007,54814
3993,3993,1909,2007-04-18 07:39:00,Something Original,37,2007,54851
3994,3994,1908,2007-04-18 07:42:00,WhiteCat,-63,2007,54788
3995,3995,1907,2007-04-18 07:43:00,Luna Santin,274,2007,55062
3996,3996,1905,2007-04-18 07:49:00,Renamed user ixgysjijel,1,2007,55063
3997,3997,1906,2007-04-18 07:49:00,59.167.53.36,33,2007,55096
3998,3998,1904,2007-04-18 07:51:00,Luna Santin,0,2007,55096
3999,3999,1903,2007-04-18 07:52:00,OneNight,-1,2007,55095
4000,4000,1902,2007-04-18 07:54:00,Luna Santin,1,2007,55096
4001,4001,1901,2007-04-18 08:10:00,125.161.12.37,0,2007,55096
4002,4002,1900,2007-04-18 08:11:00,Indus49,-5,2007,55091
4003,4003,1899,2007-04-18 08:14:00,Loren36,0,2007,55091
4004,4004,1898,2007-04-18 08:19:00,Abe Lincoln,15,2007,55106
4005,4005,1896,2007-04-18 08:25:00,86.152.203.212,1,2007,55107
4006,4006,1897,2007-04-18 08:25:00,86.152.203.212,7,2007,55114
4007,4007,1895,2007-04-18 08:27:00,86.152.203.212,-4,2007,55110
4008,4008,1894,2007-04-18 08:31:00,144.136.91.62,74,2007,55184
4009,4009,1893,2007-04-18 08:35:00,Chensiyuan,0,2007,55184
4010,4010,1892,2007-04-18 08:36:00,Chensiyuan,-5,2007,55179
4011,4011,1891,2007-04-18 08:37:00,Harald Hansen,30,2007,55209
4012,4012,1890,2007-04-18 08:40:00,Chensiyuan,1,2007,55210
4013,4013,1889,2007-04-18 08:45:00,Harald Hansen,1,2007,55211
4014,4014,1888,2007-04-18 08:45:00,Savage1881,0,2007,55211
4015,4015,1887,2007-04-18 08:52:00,Wchougle,187,2007,55398
4016,4016,1886,2007-04-18 08:57:00,Savage1881,-394,2007,55004
4017,4017,1885,2007-04-18 08:59:00,Sam Li,51,2007,55055
4018,4018,1884,2007-04-18 09:01:00,141.85.172.30,27,2007,55082
4019,4019,1883,2007-04-18 09:02:00,SpuriousQ,-27,2007,55055
4020,4020,1882,2007-04-18 09:03:00,141.85.172.30,-17,2007,55038
4021,4021,1881,2007-04-18 09:03:00,SpuriousQ,17,2007,55055
4022,4022,1880,2007-04-18 09:17:00,ColdCase,0,2007,55055
4023,4023,1879,2007-04-18 09:24:00,203.173.53.101,1,2007,55056
4024,4024,1878,2007-04-18 09:28:00,Chuq,-1,2007,55055
4025,4025,1877,2007-04-18 09:29:00,MollyTheCat,0,2007,55055
4026,4026,1876,2007-04-18 09:31:00,62.253.245.100,3,2007,55058
4027,4027,1875,2007-04-18 09:33:00,12.44.170.10,-1,2007,55057
4028,4028,1874,2007-04-18 09:36:00,Monkeyblue,3,2007,55060
4029,4029,1873,2007-04-18 09:41:00,171.161.160.10,-38,2007,55022
4030,4030,1872,2007-04-18 09:44:00,Monkeyblue,230,2007,55252
4031,4031,1871,2007-04-18 09:46:00,Manchurian candidate,57,2007,55309
4032,4032,1870,2007-04-18 09:49:00,24.160.165.16,16,2007,55325
4033,4033,1869,2007-04-18 09:50:00,Monkeyblue,46,2007,55371
4034,4034,1868,2007-04-18 09:52:00,24.160.165.16,-1,2007,55370
4035,4037,1865,2007-04-18 09:54:00,Nagromtpc,91,2007,55461
4036,4035,1867,2007-04-18 09:54:00,Bogdangiusca,-15,2007,55446
4037,4036,1866,2007-04-18 09:54:00,203.214.36.144,-8,2007,55438
4038,4038,1864,2007-04-18 09:55:00,MTN~enwiki,-52,2007,55386
4039,4039,1863,2007-04-18 09:56:00,Abe Lincoln,-17,2007,55369
4040,4040,1862,2007-04-18 09:59:00,Rosameliamartinez,1,2007,55370
4041,4041,1861,2007-04-18 10:02:00,SmackBot,15,2007,55385
4042,4042,1859,2007-04-18 10:03:00,Anclation~enwiki,36,2007,55421
4043,4043,1860,2007-04-18 10:03:00,Abe Lincoln,-100,2007,55321
4044,4044,1858,2007-04-18 10:05:00,Oscarthecat,27,2007,55348
4045,4045,1857,2007-04-18 10:07:00,Oscarthecat,-40,2007,55308
4046,4046,1856,2007-04-18 10:07:00,65.41.106.116,-6,2007,55302
4047,4047,1855,2007-04-18 10:09:00,Oscarthecat,99,2007,55401
4048,4048,1854,2007-04-18 10:10:00,212.44.1.114,95,2007,55496
4049,4049,1853,2007-04-18 10:10:00,210.84.4.241,28,2007,55524
4050,4050,1852,2007-04-18 10:11:00,Oscarthecat,8,2007,55532
4051,4051,1851,2007-04-18 10:12:00,210.84.4.241,-5,2007,55527
4052,4052,1850,2007-04-18 10:13:00,Oscarthecat,9,2007,55536
4053,4053,1849,2007-04-18 10:14:00,Abe Lincoln,0,2007,55536
4054,4054,1848,2007-04-18 10:15:00,Oscarthecat,18,2007,55554
4055,4055,1847,2007-04-18 10:15:00,210.84.4.241,12,2007,55566
4056,4057,1845,2007-04-18 10:16:00,Chobot,-8,2007,55558
4057,4058,1844,2007-04-18 10:16:00,Paul Richter,-18,2007,55540
4058,4056,1846,2007-04-18 10:16:00,SilvaStorm,41,2007,55581
4059,4059,1843,2007-04-18 10:18:00,Kizor,-186,2007,55395
4060,4060,1842,2007-04-18 10:19:00,Simoncursitor,1,2007,55396
4061,4061,1841,2007-04-18 10:21:00,Kizor,-16,2007,55380
4062,4062,1840,2007-04-18 10:24:00,Ikilled007,-12,2007,55368
4063,4063,1839,2007-04-18 10:25:00,EnviroGranny,-341,2007,55027
4064,4064,1838,2007-04-18 10:28:00,Kizor,54,2007,55081
4065,4065,1837,2007-04-18 10:29:00,58.104.66.1,40,2007,55121
4066,4066,1836,2007-04-18 10:30:00,Abe Lincoln,-8,2007,55113
4067,4067,1835,2007-04-18 10:32:00,Abe Lincoln,-45,2007,55068
4068,4068,1834,2007-04-18 10:32:00,Wikid77,366,2007,55434
4069,4069,1833,2007-04-18 10:36:00,Wikid77,1,2007,55435
4070,4070,1832,2007-04-18 10:39:00,Armanikid,44,2007,55479
4071,4071,1831,2007-04-18 10:43:00,Mikehelms,24,2007,55503
4072,4072,1830,2007-04-18 10:45:00,Wikid77,54,2007,55557
4073,4073,1829,2007-04-18 10:45:00,YanShen,-102,2007,55455
4074,4074,1827,2007-04-18 10:46:00,Mstare88,0,2007,55455
4075,4075,1828,2007-04-18 10:46:00,Kizor,-366,2007,55089
4076,4076,1826,2007-04-18 10:48:00,Kizor,0,2007,55089
4077,4077,1825,2007-04-18 10:52:00,Ikilled007,0,2007,55089
4078,4078,1824,2007-04-18 10:53:00,Ikilled007,12,2007,55101
4079,4080,1823,2007-04-18 10:54:00,Oscarthecat,188,2007,55289
4080,4079,1822,2007-04-18 10:54:00,Ikilled007,2,2007,55291
4081,4081,1820,2007-04-18 10:59:00,Wikid77,25,2007,55316
4082,4082,1819,2007-04-18 10:59:00,Kizor,0,2007,55316
4083,4083,1821,2007-04-18 10:59:00,Ikilled007,-99,2007,55217
4084,4084,1818,2007-04-18 11:02:00,Wikid77,-20,2007,55197
4085,4085,1817,2007-04-18 11:04:00,Ikilled007,292,2007,55489
4086,4086,1816,2007-04-18 11:04:00,THF,0,2007,55489
4087,4087,1815,2007-04-18 11:06:00,THF,6,2007,55495
4088,4088,1814,2007-04-18 11:07:00,Ikilled007,86,2007,55581
4089,4089,1813,2007-04-18 11:08:00,Ikilled007,0,2007,55581
4090,4090,1812,2007-04-18 11:09:00,Foragido,272,2007,55853
4091,4092,1811,2007-04-18 11:10:00,VoABot II,-272,2007,55581
4092,4091,1810,2007-04-18 11:10:00,Ikilled007,49,2007,55630
4093,4093,1809,2007-04-18 11:11:00,Wikid77,39,2007,55669
4094,4094,1808,2007-04-18 11:11:00,Kizor,0,2007,55669
4095,4095,1807,2007-04-18 11:12:00,81.244.161.212,4,2007,55673
4096,4096,1806,2007-04-18 11:13:00,Kizor,-20,2007,55653
4097,4097,1805,2007-04-18 11:13:00,Wikid77,22,2007,55675
4098,4098,1804,2007-04-18 11:15:00,Kizor,80,2007,55755
4099,4099,1803,2007-04-18 11:17:00,193.1.132.170,-7,2007,55748
4100,4100,1802,2007-04-18 11:20:00,Foragido,287,2007,56035
4101,4101,1801,2007-04-18 11:21:00,Kizor,12,2007,56047
4102,4102,1800,2007-04-18 11:22:00,62.253.245.100,10,2007,56057
4103,4103,1799,2007-04-18 11:23:00,Oscarthecat,7,2007,56064
4104,4104,1798,2007-04-18 11:26:00,Wikid77,0,2007,56064
4105,4105,1797,2007-04-18 11:28:00,Kizor,0,2007,56064
4106,4106,1796,2007-04-18 11:29:00,Kizor,-10,2007,56054
4107,4107,1795,2007-04-18 11:36:00,62.38.216.95,-28,2007,56026
4108,4108,1794,2007-04-18 11:37:00,Halo,-285,2007,55741
4109,4109,1793,2007-04-18 11:47:00,193.77.247.34,239,2007,55980
4110,4110,1792,2007-04-18 11:50:00,Ennuified,-2,2007,55978
4111,4111,1791,2007-04-18 11:55:00,213.84.220.225,0,2007,55978
4112,4112,1790,2007-04-18 11:56:00,MER-C,0,2007,55978
4113,4114,1789,2007-04-18 11:57:00,Kizor,6,2007,55984
4114,4113,1788,2007-04-18 11:57:00,Kizor,-2,2007,55982
4115,4115,1787,2007-04-18 11:58:00,Abe Lincoln,344,2007,56326
4116,4116,1786,2007-04-18 12:00:00,Spangineer,-2,2007,56324
4117,4117,1785,2007-04-18 12:01:00,213.155.224.232,-2,2007,56322
4118,4118,1784,2007-04-18 12:01:00,Novadeath69,4,2007,56326
4119,4119,1783,2007-04-18 12:05:00,MoRsE,-1,2007,56325
4120,4120,1782,2007-04-18 12:17:00,216.12.84.97,-9,2007,56316
4121,4121,1781,2007-04-18 12:17:00,168.213.7.130,-62,2007,56254
4122,4125,1779,2007-04-18 12:18:00,Secondgen,-240,2007,56014
4123,4124,1780,2007-04-18 12:18:00,165.138.18.100,14,2007,56028
4124,4122,1777,2007-04-18 12:18:00,165.138.18.100,2,2007,56030
4125,4123,1778,2007-04-18 12:18:00,Plutor,62,2007,56092
4126,4126,1776,2007-04-18 12:19:00,Plutor,-16,2007,56076
4127,4127,1775,2007-04-18 12:23:00,Dupz,-1,2007,56075
4128,4128,1774,2007-04-18 12:25:00,RetiredUser124642196,0,2007,56075
4129,4129,1773,2007-04-18 12:29:00,Blood Red Sandman,16,2007,56091
4130,4130,1772,2007-04-18 12:33:00,Daysleeper47,154,2007,56245
4131,4131,1771,2007-04-18 12:36:00,202.78.150.165,6,2007,56251
4132,4132,1770,2007-04-18 12:37:00,AcePuppy,-18,2007,56233
4133,4133,1769,2007-04-18 12:38:00,Daysleeper47,1,2007,56234
4134,4134,1768,2007-04-18 12:39:00,Nyttend,-6,2007,56228
4135,4136,1767,2007-04-18 12:40:00,Ikilled007,19,2007,56247
4136,4135,1766,2007-04-18 12:40:00,Ikilled007,-1,2007,56246
4137,4139,1765,2007-04-18 12:41:00,SchuminWeb,0,2007,56246
4138,4138,1763,2007-04-18 12:41:00,219.29.83.120,112,2007,56358
4139,4137,1764,2007-04-18 12:41:00,Ikilled007,-1,2007,56357
4140,4140,1762,2007-04-18 12:42:00,SchuminWeb,-18,2007,56339
4141,4141,1761,2007-04-18 12:43:00,KateH,0,2007,56339
4142,4142,1760,2007-04-18 12:43:00,Daysleeper47,258,2007,56597
4143,4143,1759,2007-04-18 12:44:00,130.238.18.39,-30,2007,56567
4144,4144,1758,2007-04-18 12:44:00,Coemgenus,30,2007,56597
4145,4145,1757,2007-04-18 12:44:00,Daysleeper47,24,2007,56621
4146,4146,1755,2007-04-18 12:47:00,Abe Lincoln,-65,2007,56556
4147,4147,1756,2007-04-18 12:47:00,Yanksfan092279,-23,2007,56533
4148,4149,1754,2007-04-18 12:49:00,RockMFR,23,2007,56556
4149,4150,1753,2007-04-18 12:49:00,86.152.203.212,168,2007,56724
4150,4148,1751,2007-04-18 12:49:00,W guice,-1,2007,56723
4151,4151,1750,2007-04-18 12:50:00,72.83.111.57,-44,2007,56679
4152,4152,1749,2007-04-18 12:50:00,W guice,-4,2007,56675
4153,4153,1748,2007-04-18 12:51:00,Coemgenus,44,2007,56719
4154,4154,1747,2007-04-18 12:54:00,W guice,1,2007,56720
4155,4155,1746,2007-04-18 12:55:00,Ikilled007,-482,2007,56238
4156,4156,1745,2007-04-18 12:56:00,W guice,-28,2007,56210
4157,4157,1744,2007-04-18 12:56:00,W guice,0,2007,56210
4158,4158,1743,2007-04-18 12:57:00,Dan East,474,2007,56684
4159,4159,1742,2007-04-18 13:00:00,Dan East,86,2007,56770
4160,4160,1741,2007-04-18 13:02:00,Mikethegreen,0,2007,56770
4161,4162,1739,2007-04-18 13:04:00,71.88.99.122,0,2007,56770
4162,4161,1740,2007-04-18 13:04:00,Abe Lincoln,482,2007,57252
4163,4163,1738,2007-04-18 13:05:00,151.151.73.164,-3,2007,57249
4164,4164,1737,2007-04-18 13:06:00,71.88.99.122,4,2007,57253
4165,4165,1736,2007-04-18 13:07:00,Kiarasexton,192,2007,57445
4166,4166,1735,2007-04-18 13:07:00,199.111.226.86,184,2007,57629
4167,4167,1734,2007-04-18 13:09:00,219.29.83.120,12,2007,57641
4168,4168,1733,2007-04-18 13:10:00,Jared,1,2007,57642
4169,4169,1732,2007-04-18 13:11:00,Ronnotel,-46,2007,57596
4170,4170,1730,2007-04-18 13:12:00,219.29.83.120,-39,2007,57557
4171,4171,1731,2007-04-18 13:12:00,63.88.37.64,191,2007,57748
4172,4172,1729,2007-04-18 13:13:00,Ronnotel,-190,2007,57558
4173,4174,1727,2007-04-18 13:14:00,Ronnotel,-1,2007,57557
4174,4173,1728,2007-04-18 13:14:00,219.29.83.120,-13,2007,57544
4175,4175,1726,2007-04-18 13:15:00,Ikilled007,71,2007,57615
4176,4176,1725,2007-04-18 13:15:00,Jared,-39,2007,57576
4177,4177,1724,2007-04-18 13:16:00,Vtechlol,0,2007,57576
4178,4178,1722,2007-04-18 13:17:00,Vtechlol,0,2007,57576
4179,4179,1721,2007-04-18 13:17:00,StuffOfInterest,0,2007,57576
4180,4180,1720,2007-04-18 13:17:00,O^O,3,2007,57579
4181,4181,1723,2007-04-18 13:17:00,VoABot II,0,2007,57579
4182,4182,1719,2007-04-18 13:18:00,ElKevbo,-68,2007,57511
4183,4183,1718,2007-04-18 13:18:00,Ronnotel,-36,2007,57475
4184,4186,1716,2007-04-18 13:19:00,Ronnotel,1,2007,57476
4185,4184,1715,2007-04-18 13:19:00,ElKevbo,3,2007,57479
4186,4185,1717,2007-04-18 13:19:00,Henning M,1,2007,57480
4187,4187,1714,2007-04-18 13:22:00,Hockeyohara,-2,2007,57478
4188,4188,1713,2007-04-18 13:24:00,Timb66,-2,2007,57476
4189,4189,1712,2007-04-18 13:25:00,68.117.42.56,0,2007,57476
4190,4190,1711,2007-04-18 13:25:00,MER-C,0,2007,57476
4191,4191,1710,2007-04-18 13:29:00,Ikilled007,-7,2007,57469
4192,4192,1709,2007-04-18 13:29:00,MoodyGroove,455,2007,57924
4193,4193,1708,2007-04-18 13:31:00,Chuck Carroll,29,2007,57953
4194,4194,1707,2007-04-18 13:33:00,MoodyGroove,3,2007,57956
4195,4197,1705,2007-04-18 13:34:00,69.154.147.2,0,2007,57956
4196,4196,1706,2007-04-18 13:34:00,151.199.193.186,145,2007,58101
4197,4195,1704,2007-04-18 13:34:00,Ikilled007,-482,2007,57619
4198,4198,1702,2007-04-18 13:35:00,MoodyGroove,-1,2007,57618
4199,4199,1703,2007-04-18 13:35:00,169.139.224.178,11,2007,57629
4200,4200,1701,2007-04-18 13:36:00,169.139.224.178,2,2007,57631
4201,4201,1700,2007-04-18 13:37:00,Nmajdan,-2,2007,57629
4202,4202,1699,2007-04-18 13:38:00,Quang188,-11,2007,57618
4203,4203,1698,2007-04-18 13:40:00,84.34.143.196,-75,2007,57543
4204,4204,1697,2007-04-18 13:42:00,209.7.38.9,0,2007,57543
4205,4205,1696,2007-04-18 13:42:00,MartinBot,0,2007,57543
4206,4206,1695,2007-04-18 13:43:00,90.192.138.5,-4,2007,57539
4207,4207,1694,2007-04-18 13:44:00,Kaustuv,12,2007,57551
4208,4208,1692,2007-04-18 13:46:00,Nmajdan,-9,2007,57542
4209,4209,1693,2007-04-18 13:46:00,Oscarthecat,9,2007,57551
4210,4210,1691,2007-04-18 13:47:00,216.207.201.215,93,2007,57644
4211,4211,1690,2007-04-18 13:48:00,Oscarthecat,22,2007,57666
4212,4212,1689,2007-04-18 13:48:00,FunPika,-115,2007,57551
4213,4213,1688,2007-04-18 13:48:00,Narkstraws,0,2007,57551
4214,4214,1687,2007-04-18 13:49:00,Dale Arnett,54,2007,57605
4215,4216,1685,2007-04-18 13:50:00,Ronnotel,-16,2007,57589
4216,4217,1684,2007-04-18 13:50:00,216.207.201.215,114,2007,57703
4217,4215,1686,2007-04-18 13:50:00,Rdfox 76,0,2007,57703
4218,4218,1682,2007-04-18 13:51:00,Rdfox 76,-114,2007,57589
4219,4219,1683,2007-04-18 13:51:00,Ronnotel,1,2007,57590
4220,4220,1681,2007-04-18 13:52:00,Scientz,-11,2007,57579
4221,4221,1680,2007-04-18 13:53:00,216.207.201.215,285,2007,57864
4222,4222,1679,2007-04-18 13:54:00,FunPika,-285,2007,57579
4223,4223,1678,2007-04-18 13:56:00,Ed Poor,1,2007,57580
4224,4224,1677,2007-04-18 13:58:00,Sean William,0,2007,57580
4225,4225,1676,2007-04-18 13:58:00,Dynaflow,-1,2007,57579
4226,4226,1675,2007-04-18 13:59:00,Ed Poor,203,2007,57782
4227,4227,1674,2007-04-18 13:59:00,Sean William,12,2007,57794
4228,4228,1673,2007-04-18 14:00:00,Mrjinx,11,2007,57805
4229,4229,1672,2007-04-18 14:04:00,Nmajdan,-50,2007,57755
4230,4230,1671,2007-04-18 14:06:00,Madcoverboy,17,2007,57772
4231,4231,1670,2007-04-18 14:09:00,Twitchism,0,2007,57772
4232,4232,1669,2007-04-18 14:10:00,MoodyGroove,37,2007,57809
4233,4233,1667,2007-04-18 14:11:00,Ronnotel,11,2007,57820
4234,4234,1668,2007-04-18 14:11:00,MoodyGroove,5,2007,57825
4235,4235,1666,2007-04-18 14:13:00,Twitchism,0,2007,57825
4236,4236,1665,2007-04-18 14:13:00,MartinBot,0,2007,57825
4237,4237,1664,2007-04-18 14:16:00,MoodyGroove,-363,2007,57462
4238,4238,1663,2007-04-18 14:18:00,Kaustuv,0,2007,57462
4239,4239,1662,2007-04-18 14:19:00,Carcharoth,8,2007,57470
4240,4240,1661,2007-04-18 14:21:00,Tthaas,244,2007,57714
4241,4241,1660,2007-04-18 14:23:00,Carcharoth,-11,2007,57703
4242,4242,1658,2007-04-18 14:24:00,Pseudo-Richard,-7,2007,57696
4243,4243,1659,2007-04-18 14:24:00,...adam...,0,2007,57696
4244,4244,1657,2007-04-18 14:25:00,Mike McGregor (Can),0,2007,57696
4245,4245,1656,2007-04-18 14:27:00,Mike McGregor (Can),0,2007,57696
4246,4246,1655,2007-04-18 14:28:00,Pseudo-Richard,0,2007,57696
4247,4247,1654,2007-04-18 14:28:00,Carcharoth,360,2007,58056
4248,4248,1653,2007-04-18 14:29:00,Madcoverboy,65,2007,58121
4249,4249,1652,2007-04-18 14:29:00,Carcharoth,9,2007,58130
4250,4251,1650,2007-04-18 14:30:00,Madcoverboy,-369,2007,57761
4251,4252,1649,2007-04-18 14:30:00,MoodyGroove,-369,2007,57392
4252,4250,1651,2007-04-18 14:30:00,Jauerback,15,2007,57407
4253,4253,1648,2007-04-18 14:31:00,Madcoverboy,32,2007,57439
4254,4254,1646,2007-04-18 14:33:00,A Train,0,2007,57439
4255,4255,1647,2007-04-18 14:33:00,Madcoverboy,-244,2007,57195
4256,4256,1645,2007-04-18 14:34:00,Madcoverboy,25,2007,57220
4257,4257,1644,2007-04-18 14:35:00,Ronnotel,364,2007,57584
4258,4258,1643,2007-04-18 14:36:00,MoodyGroove,141,2007,57725
4259,4261,1640,2007-04-18 14:39:00,Carcharoth,7,2007,57732
4260,4259,1642,2007-04-18 14:39:00,450w,160,2007,57892
4261,4260,1641,2007-04-18 14:39:00,Mytwocents,130,2007,58022
4262,4262,1639,2007-04-18 14:42:00,Jauerback,2,2007,58024
4263,4264,1637,2007-04-18 14:46:00,Jauerback,22,2007,58046
4264,4263,1638,2007-04-18 14:46:00,Neo-Jay,2,2007,58048
4265,4265,1635,2007-04-18 14:47:00,Jauerback,13,2007,58061
4266,4266,1636,2007-04-18 14:47:00,Natalie Erin,0,2007,58061
4267,4267,1634,2007-04-18 14:51:00,Uriel8,99,2007,58160
4268,4268,1633,2007-04-18 14:51:00,MoodyGroove,31,2007,58191
4269,4269,1632,2007-04-18 14:52:00,MoodyGroove,-1,2007,58190
4270,4270,1630,2007-04-18 14:53:00,Natalie Erin,-17,2007,58173
4271,4271,1631,2007-04-18 14:53:00,Jauerback,98,2007,58271
4272,4273,1629,2007-04-18 14:54:00,Natalie Erin,0,2007,58271
4273,4272,1628,2007-04-18 14:54:00,MoodyGroove,0,2007,58271
4274,4274,1627,2007-04-18 14:56:00,Bellhalla,1,2007,58272
4275,4275,1626,2007-04-18 14:57:00,Natalie Erin,-44,2007,58228
4276,4276,1625,2007-04-18 14:59:00,Bbarron1980,97,2007,58325
4277,4277,1624,2007-04-18 15:01:00,Natalie Erin,0,2007,58325
4278,4278,1623,2007-04-18 15:04:00,Natalie Erin,-21,2007,58304
4279,4279,1622,2007-04-18 15:05:00,MoodyGroove,338,2007,58642
4280,4280,1621,2007-04-18 15:07:00,MoodyGroove,-4,2007,58638
4281,4281,1620,2007-04-18 15:13:00,Natalie Erin,-97,2007,58541
4282,4282,1619,2007-04-18 15:14:00,LorenzoVogelsang,209,2007,58750
4283,4283,1618,2007-04-18 15:15:00,SuperJ9587,7,2007,58757
4284,4284,1617,2007-04-18 15:17:00,Mithras.Invicti,253,2007,59010
4285,4285,1616,2007-04-18 15:18:00,PRRfan,-8,2007,59002
4286,4286,1615,2007-04-18 15:19:00,Anubis2003,0,2007,59002
4287,4287,1614,2007-04-18 15:21:00,Natalie Erin,-209,2007,58793
4288,4288,1613,2007-04-18 15:21:00,SuperJ9587,-1,2007,58792
4289,4289,1612,2007-04-18 15:22:00,Bueller 007,2,2007,58794
4290,4290,1611,2007-04-18 15:23:00,SuperJ9587,-21,2007,58773
4291,4291,1610,2007-04-18 15:26:00,Wikid77,0,2007,58773
4292,4292,1608,2007-04-18 15:30:00,SuperJ9587,50,2007,58823
4293,4293,1609,2007-04-18 15:30:00,ElKevbo,1,2007,58824
4294,4294,1606,2007-04-18 15:31:00,SuperJ9587,9,2007,58833
4295,4295,1607,2007-04-18 15:31:00,SuperJ9587,0,2007,58833
4296,4296,1605,2007-04-18 15:33:00,Bbarron1980,164,2007,58997
4297,4297,1604,2007-04-18 15:35:00,Wikid77,423,2007,59420
4298,4298,1603,2007-04-18 15:36:00,SuperJ9587,9,2007,59429
4299,4299,1602,2007-04-18 15:40:00,Sisu99,309,2007,59738
4300,4300,1601,2007-04-18 15:41:00,Halo,1,2007,59739
4301,4301,1600,2007-04-18 15:42:00,Hydnjo,-2,2007,59737
4302,4302,1599,2007-04-18 15:44:00,Hydnjo,0,2007,59737
4303,4303,1598,2007-04-18 15:47:00,Halo,4,2007,59741
4304,4304,1597,2007-04-18 15:54:00,Ronnotel,-27,2007,59714
4305,4305,1596,2007-04-18 15:59:00,ElKevbo,-3,2007,59711
4306,4306,1595,2007-04-18 15:59:00,ElKevbo,0,2007,59711
4307,4307,1594,2007-04-18 16:01:00,Benjamin22b,3,2007,59714
4308,4308,1593,2007-04-18 16:01:00,ElKevbo,0,2007,59714
4309,4309,1592,2007-04-18 16:03:00,ElKevbo,21,2007,59735
4310,4310,1591,2007-04-18 16:05:00,Ronnotel,-27,2007,59708
4311,4311,1590,2007-04-18 16:08:00,Ronnotel,-2,2007,59706
4312,4312,1589,2007-04-18 16:13:00,Halo,35,2007,59741
4313,4313,1587,2007-04-18 16:14:00,MadeYourReadThis,18,2007,59759
4314,4314,1588,2007-04-18 16:14:00,MadeYourReadThis,105,2007,59864
4315,4315,1586,2007-04-18 16:21:00,3R1C,0,2007,59864
4316,4316,1585,2007-04-18 16:26:00,W guice,-1,2007,59863
4317,4317,1584,2007-04-18 16:29:00,Elliskev,-71,2007,59792
4318,4318,1583,2007-04-18 16:31:00,ElKevbo,46,2007,59838
4319,4319,1582,2007-04-18 16:34:00,Yaf,-346,2007,59492
4320,4320,1581,2007-04-18 16:38:00,Abe Lincoln,92,2007,59584
4321,4321,1580,2007-04-18 16:39:00,Abe Lincoln,0,2007,59584
4322,4322,1579,2007-04-18 16:41:00,W guice,0,2007,59584
4323,4323,1578,2007-04-18 16:42:00,W guice,-92,2007,59492
4324,4324,1577,2007-04-18 16:44:00,Elliskev,-46,2007,59446
4325,4325,1576,2007-04-18 16:45:00,Swatjester,0,2007,59446
4326,4326,1575,2007-04-18 16:47:00,Scientz,-19,2007,59427
4327,4327,1574,2007-04-18 16:49:00,B,73,2007,59500
4328,4328,1573,2007-04-18 16:51:00,Ronnotel,19,2007,59519
4329,4329,1572,2007-04-18 16:53:00,Scientz,-19,2007,59500
4330,4330,1571,2007-04-18 16:55:00,Batman2005,-298,2007,59202
4331,4332,1569,2007-04-18 16:57:00,W guice,298,2007,59500
4332,4331,1570,2007-04-18 16:57:00,Abe Lincoln,92,2007,59592
4333,4333,1568,2007-04-18 16:59:00,Abe Lincoln,-5,2007,59587
4334,4334,1567,2007-04-18 16:59:00,W guice,14,2007,59601
4335,4335,1566,2007-04-18 16:59:00,An Answer,4,2007,59605
4336,4336,1565,2007-04-18 17:01:00,W guice,-87,2007,59518
4337,4337,1564,2007-04-18 17:01:00,Chnv,15,2007,59533
4338,4338,1563,2007-04-18 17:02:00,Scientz,1,2007,59534
4339,4339,1562,2007-04-18 17:04:00,Abe Lincoln,87,2007,59621
4340,4340,1561,2007-04-18 17:05:00,McM.bot,4,2007,59625
4341,4341,1560,2007-04-18 17:05:00,Googol plex,0,2007,59625
4342,4342,1559,2007-04-18 17:06:00,Pupster21,0,2007,59625
4343,4343,1558,2007-04-18 17:06:00,Dputig07,17,2007,59642
4344,4344,1557,2007-04-18 17:07:00,Nichalp,0,2007,59642
4345,4345,1556,2007-04-18 17:08:00,Nichalp,0,2007,59642
4346,4346,1555,2007-04-18 17:08:00,Ike9898,9,2007,59651
4347,4347,1554,2007-04-18 17:08:00,HokieRNB,-16,2007,59635
4348,4348,1553,2007-04-18 17:10:00,Dputig07,108,2007,59743
4349,4349,1552,2007-04-18 17:11:00,Dputig07,0,2007,59743
4350,4350,1551,2007-04-18 17:14:00,Jared,-18,2007,59725
4351,4351,1549,2007-04-18 17:15:00,Jared,-7,2007,59718
4352,4352,1550,2007-04-18 17:15:00,PWC1004,4,2007,59722
4353,4353,1548,2007-04-18 17:17:00,Michaelversion1,120,2007,59842
4354,4354,1547,2007-04-18 17:17:00,Michaelversion1,-6,2007,59836
4355,4355,1546,2007-04-18 17:17:00,MrCalifornia,0,2007,59836
4356,4357,1544,2007-04-18 17:18:00,PWC1004,4,2007,59840
4357,4356,1545,2007-04-18 17:18:00,MrCalifornia,0,2007,59840
4358,4358,1543,2007-04-18 17:19:00,HokieRNB,-113,2007,59727
4359,4359,1542,2007-04-18 17:19:00,MrCalifornia,-81,2007,59646
4360,4360,1538,2007-04-18 17:20:00,MrCalifornia,0,2007,59646
4361,4361,1539,2007-04-18 17:20:00,MoodyGroove,8,2007,59654
4362,4362,1541,2007-04-18 17:20:00,Gotyear,38,2007,59692
4363,4363,1540,2007-04-18 17:20:00,Arsonal,6,2007,59698
4364,4364,1536,2007-04-18 17:21:00,PWC1004,20,2007,59718
4365,4365,1537,2007-04-18 17:21:00,MrCalifornia,-6,2007,59712
4366,4366,1535,2007-04-18 17:22:00,PWC1004,4,2007,59716
4367,4368,1533,2007-04-18 17:26:00,Retired username,-36,2007,59680
4368,4367,1534,2007-04-18 17:26:00,SouthernNights,43,2007,59723
4369,4369,1532,2007-04-18 17:27:00,Laurent Van Winckel,7,2007,59730
4370,4370,1531,2007-04-18 17:27:00,Starks,-3,2007,59727
4371,4371,1530,2007-04-18 17:30:00,Munit2k5,0,2007,59727
4372,4372,1529,2007-04-18 17:31:00,HokieRNB,-1,2007,59726
4373,4373,1528,2007-04-18 17:32:00,Moreschi,0,2007,59726
4374,4374,1527,2007-04-18 17:35:00,MoodyGroove,3,2007,59729
4375,4375,1526,2007-04-18 17:38:00,Mrjinx,-49,2007,59680
4376,4376,1525,2007-04-18 17:39:00,Anetode,-9,2007,59671
4377,4377,1524,2007-04-18 17:40:00,Gareth Wyn,200,2007,59871
4378,4378,1523,2007-04-18 17:43:00,Anetode,-78,2007,59793
4379,4379,1522,2007-04-18 17:48:00,Kirbyrockz,1,2007,59794
4380,4380,1521,2007-04-18 17:48:00,Arsonal,204,2007,59998
4381,4381,1519,2007-04-18 17:49:00,Iceberg007,158,2007,60156
4382,4382,1520,2007-04-18 17:49:00,Arsonal,12,2007,60168
4383,4383,1518,2007-04-18 17:53:00,Dan East,-4,2007,60164
4384,4384,1517,2007-04-18 17:54:00,W guice,-87,2007,60077
4385,4385,1516,2007-04-18 17:55:00,KazakhPol,-130,2007,59947
4386,4386,1515,2007-04-18 17:56:00,Ronnotel,-140,2007,59807
4387,4387,1514,2007-04-19 00:00:00,Halo,154,2007,59961
4388,4388,1513,2007-04-19 00:03:00,Bolt Vanderhuge,30,2007,59991
4389,4390,1511,2007-04-19 00:06:00,AceYYC,1,2007,59992
4390,4389,1512,2007-04-19 00:06:00,Sfmammamia,-315,2007,59677
4391,4391,1510,2007-04-19 00:07:00,Tydus Arandor,-1,2007,59676
4392,4392,1508,2007-04-19 00:08:00,Michelleem,-122,2007,59554
4393,4393,1509,2007-04-19 00:08:00,Jauerback,17,2007,59571
4394,4394,1507,2007-04-19 00:14:00,Guat6,75,2007,59646
4395,4395,1506,2007-04-19 00:24:00,Cherylyoung,176,2007,59822
4396,4396,1505,2007-04-19 00:25:00,Cherylyoung,2,2007,59824
4397,4397,1504,2007-04-19 00:31:00,Mcsee,4,2007,59828
4398,4398,1503,2007-04-19 00:32:00,Theleftenant,440,2007,60268
4399,4399,1502,2007-04-19 00:42:00,Theleftenant,6,2007,60274
4400,4400,1501,2007-04-19 00:44:00,AceYYC,54,2007,60328
4401,4402,1499,2007-04-19 00:45:00,Onetwo1,-2,2007,60326
4402,4401,1500,2007-04-19 00:45:00,Onetwo1,223,2007,60549
4403,4403,1497,2007-04-19 00:48:00,W guice,22,2007,60571
4404,4404,1498,2007-04-19 00:48:00,Quanticle,0,2007,60571
4405,4405,1496,2007-04-19 00:49:00,Swatjester,235,2007,60806
4406,4406,1495,2007-04-19 00:55:00,24.62.27.25,82,2007,60888
4407,4407,1494,2007-04-19 00:56:00,Guat6,123,2007,61011
4408,4408,1493,2007-04-19 00:57:00,AceYYC,-32,2007,60979
4409,4409,1492,2007-04-19 00:58:00,Ronnotel,-221,2007,60758
4410,4410,1491,2007-04-19 01:00:00,Kizor,0,2007,60758
4411,4411,1490,2007-04-19 01:01:00,67.99.36.75,4,2007,60762
4412,4412,1489,2007-04-19 01:01:00,Johnlbattista,26,2007,60788
4413,4413,1488,2007-04-19 01:02:00,Kizor,-3,2007,60785
4414,4416,1487,2007-04-19 01:05:00,168.253.21.238,221,2007,61006
4415,4415,1486,2007-04-19 01:05:00,72.73.106.54,48,2007,61054
4416,4414,1485,2007-04-19 01:05:00,AceYYC,-26,2007,61028
4417,4417,1484,2007-04-19 01:06:00,Ronnotel,0,2007,61028
4418,4418,1483,2007-04-19 01:06:00,Gerbilfyed4,0,2007,61028
4419,4419,1482,2007-04-19 01:07:00,Ronnotel,0,2007,61028
4420,4420,1480,2007-04-19 01:08:00,67.99.36.75,-14,2007,61014
4421,4421,1479,2007-04-19 01:08:00,Gerbilfyed4,1,2007,61015
4422,4422,1478,2007-04-19 01:08:00,Tinned Elk,0,2007,61015
4423,4423,1481,2007-04-19 01:08:00,Ronnotel,-6,2007,61009
4424,4424,1477,2007-04-19 01:09:00,67.99.36.75,-2,2007,61007
4425,4425,1476,2007-04-19 01:11:00,Ronnotel,-220,2007,60787
4426,4427,1474,2007-04-19 01:13:00,Xaosflux,30,2007,60817
4427,4426,1475,2007-04-19 01:13:00,67.101.193.99,0,2007,60817
4428,4428,1473,2007-04-19 01:14:00,67.99.36.75,3,2007,60820
4429,4429,1472,2007-04-19 01:15:00,Sfmammamia,-20,2007,60800
4430,4430,1471,2007-04-19 01:16:00,Cherylyoung,-4,2007,60796
4431,4431,1470,2007-04-19 01:16:00,Birdman12,268,2007,61064
4432,4432,1469,2007-04-19 01:17:00,Birdman12,4,2007,61068
4433,4433,1468,2007-04-19 01:17:00,MCCS,81,2007,61149
4434,4434,1467,2007-04-19 01:18:00,66.97.121.139,-1,2007,61148
4435,4435,1466,2007-04-19 01:19:00,HalfShadow,1,2007,61149
4436,4439,1464,2007-04-19 01:20:00,Rockpocket,-8,2007,61141
4437,4438,1465,2007-04-19 01:20:00,MCCS,44,2007,61185
4438,4436,1462,2007-04-19 01:20:00,Sfmammamia,40,2007,61225
4439,4437,1463,2007-04-19 01:20:00,MCCS,2,2007,61227
4440,4440,1461,2007-04-19 01:21:00,Ronnotel,6,2007,61233
4441,4441,1460,2007-04-19 01:21:00,Exteray,0,2007,61233
4442,4442,1459,2007-04-19 01:22:00,67.99.36.75,26,2007,61259
4443,4443,1458,2007-04-19 01:25:00,Dongdongdog,86,2007,61345
4444,4444,1457,2007-04-19 01:26:00,Jfrent,2,2007,61347
4445,4445,1456,2007-04-19 01:27:00,Birdman12,1,2007,61348
4446,4446,1455,2007-04-19 01:29:00,76.11.19.125,1,2007,61349
4447,4447,1454,2007-04-19 01:30:00,Dongdongdog,124,2007,61473
4448,4448,1453,2007-04-19 01:31:00,Ddomanickk,-4,2007,61469
4449,4449,1452,2007-04-19 01:32:00,Lipsticked Pig,-48,2007,61421
4450,4450,1450,2007-04-19 01:33:00,David Shankbone,-50,2007,61371
4451,4451,1451,2007-04-19 01:33:00,69.209.214.166,41,2007,61412
4452,4452,1449,2007-04-19 01:34:00,69.109.171.0,-1,2007,61411
4453,4453,1448,2007-04-19 01:35:00,David Shankbone,54,2007,61465
4454,4454,1447,2007-04-19 01:35:00,Googuse,24,2007,61489
4455,4455,1446,2007-04-19 01:37:00,DeusMP,356,2007,61845
4456,4456,1445,2007-04-19 01:37:00,Googuse,0,2007,61845
4457,4457,1444,2007-04-19 01:38:00,DeusMP,-459,2007,61386
4458,4458,1443,2007-04-19 01:39:00,67.190.4.129,1,2007,61387
4459,4459,1442,2007-04-19 01:40:00,Matt Gies,-2,2007,61385
4460,4462,1440,2007-04-19 01:41:00,DeusMP,4,2007,61389
4461,4460,1439,2007-04-19 01:41:00,Tinned Elk,19,2007,61408
4462,4461,1441,2007-04-19 01:41:00,Dongdongdog,5,2007,61413
4463,4463,1438,2007-04-19 01:43:00,Dongdongdog,25,2007,61438
4464,4464,1437,2007-04-19 01:44:00,Dongdongdog,-4,2007,61434
4465,4465,1436,2007-04-19 01:45:00,Gerbilfyed4,101,2007,61535
4466,4466,1435,2007-04-19 01:46:00,Qnonsense,65,2007,61600
4467,4467,1434,2007-04-19 01:46:00,X42bn6,6,2007,61606
4468,4468,1433,2007-04-19 01:47:00,Ronnotel,351,2007,61957
4469,4469,1432,2007-04-19 01:51:00,Ronnotel,-1,2007,61956
4470,4470,1431,2007-04-19 01:53:00,Smokefan2007,211,2007,62167
4471,4471,1430,2007-04-19 01:56:00,Ronnotel,-5,2007,62162
4472,4473,1428,2007-04-19 01:57:00,Sad mouse,258,2007,62420
4473,4472,1429,2007-04-19 01:57:00,Resurgent insurgent,8,2007,62428
4474,4474,1427,2007-04-19 01:58:00,Ronnotel,3,2007,62431
4475,4475,1426,2007-04-19 02:01:00,75.73.130.99,-1,2007,62430
4476,4476,1424,2007-04-19 02:05:00,Zhangwl,22,2007,62452
4477,4477,1425,2007-04-19 02:05:00,Bolt Vanderhuge,4,2007,62456
4478,4478,1423,2007-04-19 02:06:00,Mahanga,3,2007,62459
4479,4479,1422,2007-04-19 02:07:00,Zhangwl,-22,2007,62437
4480,4480,1421,2007-04-19 02:08:00,Radikaos,4,2007,62441
4481,4481,1420,2007-04-19 02:08:00,24.254.92.13,0,2007,62441
4482,4484,1417,2007-04-19 02:09:00,74.72.50.5,0,2007,62441
4483,4483,1418,2007-04-19 02:09:00,71.12.2.222,15,2007,62456
4484,4482,1419,2007-04-19 02:09:00,Sean William,0,2007,62456
4485,4485,1413,2007-04-19 02:10:00,Bolt Vanderhuge,1,2007,62457
4486,4486,1414,2007-04-19 02:10:00,HalfShadow,-15,2007,62442
4487,4487,1416,2007-04-19 02:10:00,Sean William,0,2007,62442
4488,4488,1415,2007-04-19 02:10:00,Mahanga,-107,2007,62335
4489,4489,1412,2007-04-19 02:11:00,Tyro,0,2007,62335
4490,4490,1411,2007-04-19 02:12:00,Sean William,0,2007,62335
4491,4491,1410,2007-04-19 02:12:00,Sean William,12,2007,62347
4492,4492,1409,2007-04-19 02:14:00,Sfmammamia,-45,2007,62302
4493,4493,1408,2007-04-19 02:15:00,Uriel8,29,2007,62331
4494,4494,1407,2007-04-19 02:18:00,Bolt Vanderhuge,0,2007,62331
4495,4495,1406,2007-04-19 02:22:00,Devildogmre,10,2007,62341
4496,4496,1405,2007-04-19 02:27:00,Cuchullain,2,2007,62343
4497,4497,1404,2007-04-19 02:28:00,Swatjester,-24,2007,62319
4498,4498,1402,2007-04-19 02:29:00,SNIyer12,8,2007,62327
4499,4499,1403,2007-04-19 02:29:00,SNIyer12,9,2007,62336
4500,4500,1401,2007-04-19 02:30:00,SNIyer12,2,2007,62338
4501,4501,1400,2007-04-19 02:33:00,Originalgeek,-4,2007,62334
4502,4502,1399,2007-04-19 02:35:00,Originalgeek,0,2007,62334
4503,4503,1398,2007-04-19 02:37:00,Ksyrie,32,2007,62366
4504,4504,1397,2007-04-19 02:40:00,DeusMP,0,2007,62366
4505,4505,1396,2007-04-19 02:41:00,Sfmammamia,20,2007,62386
4506,4506,1395,2007-04-19 02:43:00,Sfmammamia,-12,2007,62374
4507,4507,1394,2007-04-19 02:58:00,Mhalsall,-12,2007,62362
4508,4508,1393,2007-04-19 02:59:00,Chrishmt0423,-2,2007,62360
4509,4509,1392,2007-04-19 03:00:00,Chrishmt0423,9,2007,62369
4510,4510,1391,2007-04-19 03:06:00,Cherylyoung,0,2007,62369
4511,4511,1390,2007-04-19 03:07:00,Quarl,10,2007,62379
4512,4512,1389,2007-04-19 03:08:00,Uifz,65,2007,62444
4513,4513,1387,2007-04-19 03:10:00,Quarl,15,2007,62459
4514,4514,1388,2007-04-19 03:10:00,Nyx Abbing,1,2007,62460
4515,4515,1386,2007-04-19 03:14:00,Resurgent insurgent,-35,2007,62425
4516,4517,1384,2007-04-19 03:16:00,Flamebroil,-2,2007,62423
4517,4516,1385,2007-04-19 03:16:00,Chyu83,-2,2007,62421
4518,4518,1383,2007-04-19 03:18:00,Yvh11a,10,2007,62431
4519,4519,1382,2007-04-19 03:19:00,Uifz,68,2007,62499
4520,4520,1381,2007-04-19 03:20:00,Flavourdan,0,2007,62499
4521,4521,1380,2007-04-19 03:23:00,Mahanga,-77,2007,62422
4522,4522,1379,2007-04-19 03:24:00,KnowHow~enwiki,-8,2007,62414
4523,4523,1378,2007-04-19 03:27:00,NickW557,8,2007,62422
4524,4524,1377,2007-04-19 03:28:00,Steamclock,-67,2007,62355
4525,4525,1376,2007-04-19 03:37:00,Cherylyoung,116,2007,62471
4526,4526,1375,2007-04-19 03:38:00,Uifz,68,2007,62539
4527,4527,1374,2007-04-19 03:41:00,Sansmatthew,42,2007,62581
4528,4528,1373,2007-04-19 03:44:00,SuperJ9587,-30,2007,62551
4529,4529,1372,2007-04-19 03:48:00,GGreeneVa,-1,2007,62550
4530,4530,1371,2007-04-19 03:51:00,Cherylyoung,411,2007,62961
4531,4531,1369,2007-04-19 03:53:00,Cherylyoung,5,2007,62966
4532,4532,1370,2007-04-19 03:53:00,B,244,2007,63210
4533,4533,1368,2007-04-19 03:54:00,Vsion,-68,2007,63142
4534,4534,1367,2007-04-19 03:54:00,SuperJ9587,-138,2007,63004
4535,4535,1366,2007-04-19 03:57:00,M3andros,129,2007,63133
4536,4536,1365,2007-04-19 03:58:00,Uifz,73,2007,63206
4537,4537,1364,2007-04-19 04:01:00,Teakkettle,-1,2007,63205
4538,4538,1363,2007-04-19 04:03:00,Swamp Ig,6,2007,63211
4539,4539,1362,2007-04-19 04:05:00,Vsion,-73,2007,63138
4540,4540,1361,2007-04-19 04:06:00,Teakkettle,-297,2007,62841
4541,4541,1360,2007-04-19 04:16:00,Midkay,-8,2007,62833
4542,4542,1359,2007-04-19 04:18:00,SuperJ9587,0,2007,62833
4543,4543,1358,2007-04-19 04:22:00,Bolt Vanderhuge,-1,2007,62832
4544,4544,1357,2007-04-19 04:28:00,Sparkit,15,2007,62847
4545,4545,1356,2007-04-19 04:29:00,Shijualex,82,2007,62929
4546,4546,1355,2007-04-19 04:40:00,Before My Ken,14,2007,62943
4547,4547,1354,2007-04-19 04:45:00,Saizai,30,2007,62973
4548,4548,1353,2007-04-19 04:45:00,AceYYC,4,2007,62977
4549,4549,1352,2007-04-19 04:53:00,Mercenary2k,377,2007,63354
4550,4550,1351,2007-04-19 04:54:00,AceYYC,-377,2007,62977
4551,4551,1350,2007-04-19 04:55:00,Nyttend,20,2007,62997
4552,4553,1348,2007-04-19 04:56:00,Nyttend,4,2007,63001
4553,4552,1349,2007-04-19 04:56:00,Sfmammamia,0,2007,63001
4554,4554,1347,2007-04-19 04:58:00,Nyttend,13,2007,63014
4555,4555,1345,2007-04-19 05:03:00,Louiseallana,-25,2007,62989
4556,4556,1346,2007-04-19 05:03:00,Sfmammamia,148,2007,63137
4557,4557,1344,2007-04-19 05:04:00,Littlerascal,0,2007,63137
4558,4558,1343,2007-04-19 05:05:00,Littlerascal,-2,2007,63135
4559,4559,1342,2007-04-19 05:07:00,Ryulong,2,2007,63137
4560,4560,1341,2007-04-19 05:10:00,Littlerascal,65,2007,63202
4561,4561,1340,2007-04-19 05:11:00,Sfmammamia,-46,2007,63156
4562,4562,1339,2007-04-19 05:13:00,Littlerascal,11,2007,63167
4563,4563,1338,2007-04-19 05:15:00,Alan Russell,-1,2007,63166
4564,4564,1337,2007-04-19 05:19:00,Sfmammamia,0,2007,63166
4565,4565,1336,2007-04-19 05:24:00,Sayden,138,2007,63304
4566,4566,1335,2007-04-19 05:26:00,Littlerascal,0,2007,63304
4567,4567,1334,2007-04-19 05:32:00,Sfmammamia,-39,2007,63265
4568,4568,1333,2007-04-19 05:40:00,Chaerani,0,2007,63265
4569,4569,1332,2007-04-19 05:40:00,Chaerani,1,2007,63266
4570,4570,1331,2007-04-19 05:44:00,Saizai,204,2007,63470
4571,4571,1330,2007-04-19 05:44:00,Saizai,-2,2007,63468
4572,4572,1329,2007-04-19 05:54:00,Spangineer,0,2007,63468
4573,4573,1327,2007-04-19 05:56:00,Oscarthecat,-6,2007,63462
4574,4574,1328,2007-04-19 05:56:00,Spangineer,-7,2007,63455
4575,4575,1326,2007-04-19 05:59:00,Chaerani,497,2007,63952
4576,4576,1325,2007-04-19 06:02:00,Sfmammamia,-192,2007,63760
4577,4577,1324,2007-04-19 06:04:00,Lilkunta,-351,2007,63409
4578,4578,1323,2007-04-19 06:05:00,Radio-x,54,2007,63463
4579,4579,1322,2007-04-19 06:07:00,Yaf,16,2007,63479
4580,4580,1321,2007-04-19 06:10:00,Schulte,1,2007,63480
4581,4581,1320,2007-04-19 06:21:00,Sfmammamia,185,2007,63665
4582,4582,1319,2007-04-19 06:23:00,Sfmammamia,-1,2007,63664
4583,4583,1318,2007-04-19 06:28:00,Khoikhoi,141,2007,63805
4584,4584,1317,2007-04-19 06:34:00,Kintetsubuffalo,0,2007,63805
4585,4586,1315,2007-04-19 06:40:00,Zven,41,2007,63846
4586,4585,1316,2007-04-19 06:40:00,Ygfperson,1,2007,63847
4587,4587,1314,2007-04-19 06:41:00,Kintetsubuffalo,-204,2007,63643
4588,4588,1313,2007-04-19 06:42:00,Zven,0,2007,63643
4589,4589,1312,2007-04-19 06:47:00,Arsonal,64,2007,63707
4590,4590,1311,2007-04-19 06:48:00,Arsonal,-1,2007,63706
4591,4591,1310,2007-04-19 07:02:00,Abe Lincoln,-62,2007,63644
4592,4592,1309,2007-04-19 07:02:00,Abe Lincoln,66,2007,63710
4593,4593,1308,2007-04-19 07:05:00,Abe Lincoln,0,2007,63710
4594,4594,1307,2007-04-19 07:12:00,Brookie,4,2007,63714
4595,4595,1306,2007-04-19 07:21:00,Adraeus,54,2007,63768
4596,4596,1305,2007-04-19 07:48:00,Gab kidzc,0,2007,63768
4597,4597,1304,2007-04-19 07:56:00,Hbdragon88,7,2007,63775
4598,4598,1303,2007-04-19 08:30:00,SlimVirgin,-7,2007,63768
4599,4599,1302,2007-04-19 08:31:00,Midkay,49,2007,63817
4600,4600,1301,2007-04-19 08:32:00,Midkay,-1,2007,63816
4601,4601,1300,2007-04-19 08:42:00,SlimVirgin,-102,2007,63714
4602,4602,1299,2007-04-19 08:43:00,SlimVirgin,-223,2007,63491
4603,4603,1298,2007-04-19 08:50:00,Stevertigo,-2,2007,63489
4604,4604,1295,2007-04-19 08:53:00,Stevertigo,12,2007,63501
4605,4605,1296,2007-04-19 08:53:00,Arsonal,12,2007,63513
4606,4606,1297,2007-04-19 08:53:00,Abe Lincoln,0,2007,63513
4607,4607,1294,2007-04-19 08:56:00,Abe Lincoln,0,2007,63513
4608,4608,1292,2007-04-19 08:57:00,Sumodivebomb,2,2007,63515
4609,4609,1291,2007-04-19 09:23:00,W guice,-2,2007,63513
4610,4610,1290,2007-04-19 09:41:00,L142,181,2007,63694
4611,4611,1289,2007-04-19 09:46:00,Ixfd64,69,2007,63763
4612,4612,1288,2007-04-19 09:52:00,Nagromtpc,19,2007,63782
4613,4613,1287,2007-04-19 09:53:00,Abe Lincoln,0,2007,63782
4614,4614,1286,2007-04-19 10:00:00,Abe Lincoln,165,2007,63947
4615,4615,1285,2007-04-19 10:13:00,CloudNine,6,2007,63953
4616,4616,1284,2007-04-19 10:16:00,Quixoto,19,2007,63972
4617,4617,1283,2007-04-19 10:17:00,L142,51,2007,64023
4618,4618,1282,2007-04-19 10:22:00,Abe Lincoln,0,2007,64023
4619,4619,1281,2007-04-19 10:24:00,Premeditated Chaos,0,2007,64023
4620,4620,1280,2007-04-19 10:27:00,Premeditated Chaos,0,2007,64023
4621,4621,1279,2007-04-19 10:40:00,Dupz,-2,2007,64021
4622,4622,1278,2007-04-19 10:49:00,Isocyanide,19,2007,64040
4623,4623,1277,2007-04-19 11:03:00,Yewtree1968,118,2007,64158
4624,4624,1276,2007-04-19 11:05:00,Yewtree1968,-1,2007,64157
4625,4625,1275,2007-04-19 11:16:00,Mergy,0,2007,64157
4626,4626,1274,2007-04-19 11:21:00,AcePuppy,93,2007,64250
4627,4627,1273,2007-04-19 11:26:00,PseudoSudo,-4,2007,64246
4628,4628,1272,2007-04-19 11:28:00,Dan East,5,2007,64251
4629,4629,1271,2007-04-19 11:30:00,CloudNine,0,2007,64251
4630,4630,1270,2007-04-19 11:34:00,PseudoSudo,8,2007,64259
4631,4631,1269,2007-04-19 11:38:00,Bluefield,0,2007,64259
4632,4632,1268,2007-04-19 11:43:00,Hobblehobble,113,2007,64372
4633,4633,1267,2007-04-19 11:49:00,B,-113,2007,64259
4634,4634,1266,2007-04-19 11:59:00,Hobblehobble,113,2007,64372
4635,4635,1265,2007-04-19 12:12:00,B,-15,2007,64357
4636,4636,1264,2007-04-19 12:12:00,Tthaas,-399,2007,63958
4637,4637,1263,2007-04-19 12:18:00,Nyttend,1,2007,63959
4638,4638,1262,2007-04-19 12:31:00,LaNicoya,91,2007,64050
4639,4639,1261,2007-04-19 12:33:00,Tthaas,0,2007,64050
4640,4640,1260,2007-04-19 12:36:00,Jared,-18,2007,64032
4641,4641,1259,2007-04-19 12:37:00,ElKevbo,-38,2007,63994
4642,4642,1258,2007-04-19 12:37:00,Jared,-14,2007,63980
4643,4643,1257,2007-04-19 12:40:00,ElKevbo,-38,2007,63942
4644,4645,1255,2007-04-19 12:47:00,Uncle G,33,2007,63975
4645,4644,1256,2007-04-19 12:47:00,HokieRNB,-19,2007,63956
4646,4646,1254,2007-04-19 12:58:00,Jared,46,2007,64002
4647,4647,1253,2007-04-19 13:02:00,Jauerback,6,2007,64008
4648,4648,1252,2007-04-19 13:05:00,Jauerback,-16,2007,63992
4649,4649,1249,2007-04-19 13:06:00,Coemgenus,-1,2007,63991
4650,4650,1250,2007-04-19 13:06:00,Jivecat,-3,2007,63988
4651,4651,1251,2007-04-19 13:06:00,Coemgenus,2,2007,63990
4652,4652,1248,2007-04-19 13:20:00,Jauerback,10,2007,64000
4653,4653,1247,2007-04-19 13:22:00,Scifiintel,22,2007,64022
4654,4654,1246,2007-04-19 13:23:00,Petri Krohn,31,2007,64053
4655,4655,1245,2007-04-19 13:31:00,Jauerback,84,2007,64137
4656,4656,1244,2007-04-19 13:37:00,Jauerback,13,2007,64150
4657,4657,1243,2007-04-19 13:38:00,Abe Lincoln,0,2007,64150
4658,4658,1242,2007-04-19 13:39:00,Jared,-13,2007,64137
4659,4659,1241,2007-04-19 13:43:00,StuffOfInterest,0,2007,64137
4660,4660,1240,2007-04-19 13:44:00,Quadell,-20,2007,64117
4661,4661,1239,2007-04-19 13:47:00,Abe Lincoln,0,2007,64117
4662,4662,1238,2007-04-19 13:48:00,Ronnotel,-3,2007,64114
4663,4663,1236,2007-04-19 13:50:00,Quadell,21,2007,64135
4664,4664,1237,2007-04-19 13:50:00,De Administrando Imperio,-229,2007,63906
4665,4665,1235,2007-04-19 13:52:00,Bree123,1,2007,63907
4666,4666,1234,2007-04-19 13:53:00,HokieRNB,206,2007,64113
4667,4667,1233,2007-04-19 13:53:00,HokieRNB,5,2007,64118
4668,4668,1232,2007-04-19 13:56:00,StuffOfInterest,27,2007,64145
4669,4669,1231,2007-04-19 13:59:00,Abe Lincoln,-61,2007,64084
4670,4670,1230,2007-04-19 13:59:00,Abe Lincoln,0,2007,64084
4671,4671,1229,2007-04-19 14:00:00,Bree123,-4,2007,64080
4672,4672,1228,2007-04-19 14:02:00,HokieRNB,-5,2007,64075
4673,4673,1227,2007-04-19 14:04:00,The Sports Diatribe,0,2007,64075
4674,4674,1226,2007-04-19 14:07:00,The Sports Diatribe,18,2007,64093
4675,4675,1225,2007-04-19 14:08:00,The Sports Diatribe,0,2007,64093
4676,4676,1224,2007-04-19 14:09:00,De Administrando Imperio,0,2007,64093
4677,4677,1223,2007-04-19 14:14:00,Doc glasgow,-21,2007,64072
4678,4679,1221,2007-04-19 14:17:00,Dale Arnett,54,2007,64126
4679,4678,1222,2007-04-19 14:17:00,Balthazarduju,-198,2007,63928
4680,4680,1220,2007-04-19 14:18:00,Balthazarduju,-1,2007,63927
4681,4681,1219,2007-04-19 14:20:00,Badluckprince,-3,2007,63924
4682,4682,1218,2007-04-19 14:20:00,Natalie Erin,4,2007,63928
4683,4683,1217,2007-04-19 14:23:00,Itsdave101,11,2007,63939
4684,4684,1216,2007-04-19 14:24:00,Natalie Erin,0,2007,63939
4685,4685,1214,2007-04-19 14:25:00,Cherylyoung,382,2007,64321
4686,4686,1213,2007-04-19 14:27:00,Natalie Erin,145,2007,64466
4687,4687,1211,2007-04-19 14:29:00,Gerash77,231,2007,64697
4688,4688,1212,2007-04-19 14:29:00,Natalie Erin,-3,2007,64694
4689,4689,1210,2007-04-19 14:30:00,87.217.249.231,33,2007,64727
4690,4691,1208,2007-04-19 14:31:00,StuffOfInterest,0,2007,64727
4691,4690,1209,2007-04-19 14:31:00,Natalie Erin,-29,2007,64698
4692,4692,1207,2007-04-19 14:33:00,Tonicthebrown,230,2007,64928
4693,4693,1206,2007-04-19 14:33:00,Natalie Erin,-47,2007,64881
4694,4694,1205,2007-04-19 14:33:00,Cherylyoung,41,2007,64922
4695,4695,1204,2007-04-19 14:34:00,Natalie Erin,-1,2007,64921
4696,4696,1203,2007-04-19 14:35:00,Natalie Erin,-1,2007,64920
4697,4697,1202,2007-04-19 14:36:00,Natalie Erin,-42,2007,64878
4698,4698,1200,2007-04-19 14:38:00,75.46.189.134,95,2007,64973
4699,4699,1201,2007-04-19 14:38:00,Natalie Erin,-5,2007,64968
4700,4700,1199,2007-04-19 14:39:00,Jauerback,4,2007,64972
4701,4703,1196,2007-04-19 14:40:00,Natalie Erin,-1,2007,64971
4702,4702,1197,2007-04-19 14:40:00,Natalie Erin,1,2007,64972
4703,4701,1198,2007-04-19 14:40:00,Sad mouse,265,2007,65237
4704,4704,1195,2007-04-19 14:41:00,Zehly,12,2007,65249
4705,4705,1194,2007-04-19 14:42:00,Natalie Erin,-1,2007,65248
4706,4706,1193,2007-04-19 14:44:00,Natalie Erin,-1,2007,65247
4707,4707,1192,2007-04-19 14:44:00,Joncnunn,-3,2007,65244
4708,4708,1191,2007-04-19 14:44:00,216.79.2.6,-1,2007,65243
4709,4709,1190,2007-04-19 14:44:00,StuffOfInterest,1,2007,65244
4710,4710,1189,2007-04-19 14:46:00,Natalie Erin,-2,2007,65242
4711,4711,1188,2007-04-19 14:47:00,Natalie Erin,-9,2007,65233
4712,4712,1187,2007-04-19 14:49:00,Natalie Erin,-1,2007,65232
4713,4714,1185,2007-04-19 14:51:00,Natalie Erin,-2,2007,65230
4714,4713,1186,2007-04-19 14:51:00,Spangineer,60,2007,65290
4715,4715,1184,2007-04-19 14:52:00,StuffOfInterest,-43,2007,65247
4716,4716,1183,2007-04-19 14:54:00,Zenohockey,14,2007,65261
4717,4717,1182,2007-04-19 14:54:00,Cracker989,378,2007,65639
4718,4718,1181,2007-04-19 14:55:00,69.109.253.89,13,2007,65652
4719,4719,1180,2007-04-19 14:55:00,StuffOfInterest,-7,2007,65645
4720,4720,1179,2007-04-19 15:00:00,Wafulz,-6,2007,65639
4721,4721,1178,2007-04-19 15:01:00,150.176.208.98,-13,2007,65626
4722,4722,1177,2007-04-19 15:05:00,Lord Bodak,112,2007,65738
4723,4723,1176,2007-04-19 15:05:00,71.238.69.7,-378,2007,65360
4724,4725,1174,2007-04-19 15:08:00,Moreschi,-311,2007,65049
4725,4724,1175,2007-04-19 15:08:00,63.116.24.194,311,2007,65360
4726,4726,1173,2007-04-19 15:12:00,168.8.120.2,73,2007,65433
4727,4727,1172,2007-04-19 15:13:00,Pascal.Tesson,-73,2007,65360
4728,4728,1171,2007-04-19 15:14:00,QuickTime~enwiki,127,2007,65487
4729,4729,1170,2007-04-19 15:14:00,132.206.157.26,264,2007,65751
4730,4730,1169,2007-04-19 15:15:00,QuickTime~enwiki,-10,2007,65741
4731,4731,1168,2007-04-19 15:16:00,69.109.253.89,13,2007,65754
4732,4734,1166,2007-04-19 15:17:00,Angmering,-13,2007,65741
4733,4732,1165,2007-04-19 15:17:00,Scientz,-13,2007,65728
4734,4733,1167,2007-04-19 15:17:00,132.206.157.26,162,2007,65890
4735,4735,1164,2007-04-19 15:23:00,61.228.66.176,0,2007,65890
4736,4736,1163,2007-04-19 15:25:00,Chinese3126,18,2007,65908
4737,4737,1162,2007-04-19 15:26:00,Scientz,0,2007,65908
4738,4738,1161,2007-04-19 15:30:00,Zehly,9,2007,65917
4739,4739,1160,2007-04-19 15:32:00,Ronnotel,-8,2007,65909
4740,4740,1159,2007-04-19 15:32:00,Abe Lincoln,0,2007,65909
4741,4741,1158,2007-04-19 15:32:00,Scientz,-1,2007,65908
4742,4742,1157,2007-04-19 15:33:00,SkyWalker,-275,2007,65633
4743,4743,1156,2007-04-19 15:33:00,206.78.245.35,6,2007,65639
4744,4744,1155,2007-04-19 15:34:00,Sfmammamia,-6,2007,65633
4745,4745,1154,2007-04-19 15:35:00,Scientz,275,2007,65908
4746,4748,1151,2007-04-19 15:36:00,74.92.137.206,3,2007,65911
4747,4747,1153,2007-04-19 15:36:00,206.78.245.35,5,2007,65916
4748,4746,1152,2007-04-19 15:36:00,Scientz,0,2007,65916
4749,4749,1150,2007-04-19 15:37:00,74.92.137.206,-3,2007,65913
4750,4750,1149,2007-04-19 15:37:00,Abe Lincoln,0,2007,65913
4751,4751,1148,2007-04-19 15:41:00,HongQiGong,-5,2007,65908
4752,4752,1147,2007-04-19 15:43:00,HongQiGong,-10,2007,65898
4753,4753,1146,2007-04-19 15:46:00,Ronnotel,0,2007,65898
4754,4754,1144,2007-04-19 15:49:00,Ali'i,-94,2007,65804
4755,4755,1145,2007-04-19 15:49:00,Karrmann,20,2007,65824
4756,4756,1143,2007-04-19 15:50:00,Ronnotel,-443,2007,65381
4757,4757,1142,2007-04-19 15:51:00,Ronnotel,-1,2007,65380
4758,4758,1141,2007-04-19 15:52:00,Ronnotel,-394,2007,64986
4759,4759,1140,2007-04-19 15:55:00,Ronnotel,-86,2007,64900
4760,4760,1139,2007-04-19 15:58:00,Sfmammamia,22,2007,64922
4761,4761,1138,2007-04-19 16:00:00,Ronnotel,-194,2007,64728
4762,4762,1137,2007-04-19 16:01:00,WhisperToMe,56,2007,64784
4763,4763,1136,2007-04-19 16:03:00,Ronnotel,0,2007,64784
4764,4764,1135,2007-04-19 16:06:00,204.111.162.41,106,2007,64890
4765,4765,1134,2007-04-19 16:10:00,Ronnotel,0,2007,64890
4766,4766,1133,2007-04-19 16:12:00,Natalie Erin,0,2007,64890
4767,4767,1132,2007-04-19 16:13:00,Natalie Erin,-19,2007,64871
4768,4768,1131,2007-04-19 16:13:00,164.107.223.217,0,2007,64871
4769,4769,1130,2007-04-19 16:15:00,164.107.223.217,0,2007,64871
4770,4770,1128,2007-04-19 16:16:00,DerHexer,0,2007,64871
4771,4771,1125,2007-04-19 16:18:00,72.224.222.46,360,2007,65231
4772,4772,1124,2007-04-19 16:18:00,164.107.223.217,0,2007,65231
4773,4773,1126,2007-04-19 16:18:00,SuperJ9587,16,2007,65247
4774,4774,1123,2007-04-19 16:19:00,SuperJ9587,0,2007,65247
4775,4775,1122,2007-04-19 16:20:00,Natalie Erin,-151,2007,65096
4776,4776,1121,2007-04-19 16:20:00,Zehly,13,2007,65109
4777,4777,1120,2007-04-19 16:20:00,Wcseniors07,83,2007,65192
4778,4778,1119,2007-04-19 16:21:00,Natalie Erin,150,2007,65342
4779,4779,1118,2007-04-19 16:21:00,66.76.60.154,-150,2007,65192
4780,4780,1117,2007-04-19 16:22:00,70.58.31.115,22,2007,65214
4781,4781,1116,2007-04-19 16:23:00,RobNS,-22,2007,65192
4782,4783,1114,2007-04-19 16:24:00,Ali'i,-111,2007,65081
4783,4782,1115,2007-04-19 16:24:00,Itsfullofstars,3,2007,65084
4784,4784,1113,2007-04-19 16:25:00,Ronnotel,0,2007,65084
4785,4785,1112,2007-04-19 16:26:00,Jaegen,-83,2007,65001
4786,4786,1111,2007-04-19 16:31:00,129.79.135.192,0,2007,65001
4787,4787,1110,2007-04-19 16:32:00,Halo,0,2007,65001
4788,4788,1109,2007-04-19 16:32:00,Ronnotel,0,2007,65001
4789,4789,1108,2007-04-19 16:36:00,Ronnotel,-394,2007,64607
4790,4790,1107,2007-04-19 16:36:00,Merzul,2,2007,64609
4791,4791,1106,2007-04-19 16:37:00,Ronnotel,-80,2007,64529
4792,4792,1105,2007-04-19 16:37:00,Merzul,1,2007,64530
4793,4793,1104,2007-04-19 16:38:00,Ronnotel,-469,2007,64061
4794,4794,1103,2007-04-19 16:40:00,172.144.133.172,0,2007,64061
4795,4795,1102,2007-04-19 16:41:00,172.144.133.172,-2,2007,64059
4796,4796,1101,2007-04-19 16:44:00,Sfmammamia,249,2007,64308
4797,4797,1100,2007-04-19 16:46:00,WJBscribe,-13,2007,64295
4798,4798,1098,2007-04-19 16:47:00,Abe Lincoln,-49,2007,64246
4799,4799,1099,2007-04-19 16:47:00,A Train,4,2007,64250
4800,4800,1097,2007-04-19 16:48:00,220.235.150.166,8,2007,64258
4801,4801,1096,2007-04-19 16:49:00,Jared,-3,2007,64255
4802,4802,1095,2007-04-19 16:51:00,Rich Farmbrough,64,2007,64319
4803,4803,1094,2007-04-19 16:54:00,Rich Farmbrough,23,2007,64342
4804,4805,1092,2007-04-19 16:55:00,Chuck Sirloin,0,2007,64342
4805,4804,1093,2007-04-19 16:55:00,Sad mouse,15,2007,64357
4806,4806,1091,2007-04-19 16:57:00,207.73.23.170,0,2007,64357
4807,4807,1090,2007-04-19 16:57:00,DerHexer,0,2007,64357
4808,4808,1086,2007-04-19 16:58:00,DerHexer,0,2007,64357
4809,4809,1087,2007-04-19 16:58:00,207.73.23.170,0,2007,64357
4810,4810,1085,2007-04-19 16:59:00,Halo,0,2007,64357
4811,4811,1084,2007-04-19 17:01:00,Halo,0,2007,64357
4812,4812,1083,2007-04-19 17:02:00,129.215.149.99,106,2007,64463
4813,4813,1082,2007-04-19 17:02:00,Halo,325,2007,64788
4814,4816,1079,2007-04-19 17:05:00,155.72.24.1,3,2007,64791
4815,4815,1080,2007-04-19 17:05:00,Hiwhispees,77,2007,64868
4816,4814,1081,2007-04-19 17:05:00,Halo,22,2007,64890
4817,4817,1078,2007-04-19 17:06:00,Zehly,13,2007,64903
4818,4818,1077,2007-04-19 17:07:00,Hiwhispees,0,2007,64903
4819,4819,1076,2007-04-19 17:08:00,Fritz Saalfeld,-5,2007,64898
4820,4820,1075,2007-04-19 17:09:00,168.216.28.111,0,2007,64898
4821,4821,1074,2007-04-19 17:10:00,DerHexer,0,2007,64898
4822,4822,1073,2007-04-19 17:10:00,159.140.254.10,-9,2007,64889
4823,4823,1072,2007-04-19 17:11:00,Rich Farmbrough,30,2007,64919
4824,4824,1071,2007-04-19 17:11:00,132.206.157.26,86,2007,65005
4825,4825,1070,2007-04-19 17:11:00,132.206.157.26,34,2007,65039
4826,4826,1069,2007-04-19 17:12:00,Coemgenus,-1,2007,65038
4827,4827,1068,2007-04-19 17:14:00,Rich Farmbrough,18,2007,65056
4828,4828,1067,2007-04-19 17:15:00,Rich Farmbrough,38,2007,65094
4829,4829,1065,2007-04-19 17:18:00,168.169.110.137,212,2007,65306
4830,4830,1066,2007-04-19 17:18:00,207.7.222.227,0,2007,65306
4831,4831,1064,2007-04-19 17:19:00,Edgeofnowhere,-211,2007,65095
4832,4832,1063,2007-04-19 17:23:00,Kevinp2,199,2007,65294
4833,4833,1062,2007-04-19 17:26:00,69.58.45.10,57,2007,65351
4834,4834,1061,2007-04-19 17:26:00,Nivix,-57,2007,65294
4835,4835,1060,2007-04-19 17:27:00,69.58.45.10,36,2007,65330
4836,4836,1059,2007-04-19 17:28:00,Nivix,-36,2007,65294
4837,4837,1058,2007-04-19 17:28:00,Scientz,0,2007,65294
4838,4838,1057,2007-04-19 17:28:00,69.58.45.10,34,2007,65328
4839,4842,1054,2007-04-19 17:29:00,Scientz,0,2007,65328
4840,4841,1056,2007-04-19 17:29:00,Nivix,-34,2007,65294
4841,4839,1053,2007-04-19 17:29:00,Hughsonj,-106,2007,65188
4842,4840,1055,2007-04-19 17:29:00,Halo,24,2007,65212
4843,4843,1051,2007-04-19 17:30:00,Natalie Erin,4,2007,65216
4844,4844,1052,2007-04-19 17:30:00,Ronnotel,-77,2007,65139
4845,4845,1049,2007-04-19 17:31:00,Natalie Erin,-4,2007,65135
4846,4846,1050,2007-04-19 17:31:00,Halo,2,2007,65137
4847,4847,1048,2007-04-19 17:33:00,Scientz,0,2007,65137
4848,4848,1047,2007-04-19 17:39:00,Natalie Erin,6,2007,65143
4849,4849,1046,2007-04-19 17:41:00,168.169.134.156,-1,2007,65142
4850,4850,1045,2007-04-19 17:41:00,Coemgenus,1,2007,65143
4851,4851,1044,2007-04-19 17:42:00,Ronnotel,0,2007,65143
4852,4852,1043,2007-04-19 17:43:00,Ronnotel,-2,2007,65141
4853,4853,1042,2007-04-19 17:44:00,Natalie Erin,6,2007,65147
4854,4854,1040,2007-04-19 17:48:00,LuigiManiac,-12,2007,65135
4855,4855,1041,2007-04-19 17:48:00,208.108.91.126,12,2007,65147
4856,4856,1039,2007-04-19 17:49:00,Vetshrink,240,2007,65387
4857,4857,1038,2007-04-19 17:50:00,168.169.102.132,18,2007,65405
4858,4858,1037,2007-04-19 17:50:00,Nivix,-18,2007,65387
4859,4859,1036,2007-04-19 17:51:00,151.199.192.107,1,2007,65388
4860,4860,1035,2007-04-19 17:51:00,Swatjester,0,2007,65388
4861,4861,1034,2007-04-19 17:52:00,Swatjester,22,2007,65410
4862,4862,1033,2007-04-19 17:59:00,TheDarknessVisible,-240,2007,65170
4863,4863,1032,2007-04-19 18:03:00,Uucp,8,2007,65178
4864,4864,1031,2007-04-19 18:07:00,Cherylyoung,9,2007,65187
4865,4865,1030,2007-04-19 18:08:00,Zondor,70,2007,65257
4866,4866,1028,2007-04-19 18:09:00,Sad mouse,15,2007,65272
4867,4867,1029,2007-04-19 18:09:00,Cherylyoung,0,2007,65272
4868,4868,1026,2007-04-19 18:10:00,Markm62,-118,2007,65154
4869,4869,1027,2007-04-19 18:10:00,Cherylyoung,2,2007,65156
4870,4870,1025,2007-04-19 18:11:00,Markm62,-85,2007,65071
4871,4871,1024,2007-04-19 18:12:00,Cherylyoung,-1,2007,65070
4872,4872,1023,2007-04-19 18:12:00,Sfmammamia,-125,2007,64945
4873,4873,1022,2007-04-19 18:13:00,Pseudo-Richard,31,2007,64976
4874,4875,1020,2007-04-19 18:14:00,Markm62,-265,2007,64711
4875,4874,1021,2007-04-19 18:14:00,Cherylyoung,0,2007,64711
4876,4876,1018,2007-04-19 18:16:00,Cherylyoung,5,2007,64716
4877,4877,1019,2007-04-19 18:16:00,Markm62,7,2007,64723
4878,4878,1016,2007-04-19 18:18:00,Cherylyoung,0,2007,64723
4879,4879,1015,2007-04-19 18:18:00,Trilemma,14,2007,64737
4880,4880,1014,2007-04-19 18:18:00,Markm62,87,2007,64824
4881,4881,1017,2007-04-19 18:18:00,Trilemma,-1,2007,64823
4882,4882,1013,2007-04-19 18:21:00,Cherylyoung,9,2007,64832
4883,4883,1012,2007-04-19 18:24:00,Brokendownsubaruoutback,0,2007,64832
4884,4884,1011,2007-04-19 18:25:00,Cherylyoung,-42,2007,64790
4885,4885,1010,2007-04-19 18:26:00,Markm62,-62,2007,64728
4886,4886,1009,2007-04-19 18:28:00,Brighterorange,6,2007,64734
4887,4887,1008,2007-04-19 18:30:00,Cherylyoung,384,2007,65118
4888,4888,1007,2007-04-19 18:33:00,Brighterorange,0,2007,65118
4889,4889,1006,2007-04-19 18:37:00,GunnarRene,0,2007,65118
4890,4890,1005,2007-04-19 18:40:00,Abe Lincoln,0,2007,65118
4891,4891,1004,2007-04-19 18:43:00,Ckerstiens,420,2007,65538
4892,4892,1003,2007-04-19 18:44:00,Yksin,0,2007,65538
4893,4893,1002,2007-04-19 18:50:00,B. Jennings Perry,-68,2007,65470
4894,4894,1001,2007-04-19 18:50:00,Ike9898,0,2007,65470
4895,4895,1000,2007-04-19 18:51:00,Chrishmt0423,0,2007,65470
4896,4896,999,2007-04-19 18:52:00,Chrishmt0423,6,2007,65476
4897,4897,998,2007-04-19 18:54:00,Sfmammamia,-81,2007,65395
4898,4898,997,2007-04-19 18:58:00,Halo,0,2007,65395
4899,4899,996,2007-04-19 18:58:00,Halo,-13,2007,65382
4900,4900,995,2007-04-19 19:03:00,Halo,28,2007,65410
4901,4901,994,2007-04-19 19:04:00,Xxhellslayerxx,230,2007,65640
4902,4902,992,2007-04-19 19:06:00,Sfmammamia,5,2007,65645
4903,4903,991,2007-04-19 19:06:00,Darrik2,79,2007,65724
4904,4904,993,2007-04-19 19:06:00,Darrik2,123,2007,65847
4905,4905,990,2007-04-19 19:07:00,Ronnotel,-233,2007,65614
4906,4906,989,2007-04-19 19:09:00,Darrik2,7,2007,65621
4907,4908,987,2007-04-19 19:20:00,Natalie Erin,12,2007,65633
4908,4907,988,2007-04-19 19:20:00,Tfine80,-231,2007,65402
4909,4909,986,2007-04-19 19:21:00,Natalie Erin,0,2007,65402
4910,4910,985,2007-04-19 19:24:00,Halo,29,2007,65431
4911,4911,984,2007-04-19 19:29:00,Abe Lincoln,85,2007,65516
4912,4912,983,2007-04-19 19:32:00,Eyeless~enwiki,-1,2007,65515
4913,4913,982,2007-04-19 19:33:00,Jambalaya~enwiki,18,2007,65533
4914,4914,981,2007-04-19 19:34:00,Natalie Erin,-208,2007,65325
4915,4915,980,2007-04-19 19:34:00,Yaf,5,2007,65330
4916,4916,979,2007-04-19 19:36:00,Efyoo,-22,2007,65308
4917,4922,973,2007-04-19 19:37:00,Yaf,18,2007,65326
4918,4921,974,2007-04-19 19:37:00,Natalie Erin,-1,2007,65325
4919,4920,975,2007-04-19 19:37:00,GunnarRene,223,2007,65548
4920,4919,976,2007-04-19 19:37:00,Efyoo,-2,2007,65546
4921,4918,977,2007-04-19 19:37:00,Natalie Erin,0,2007,65546
4922,4917,978,2007-04-19 19:37:00,Yaf,-126,2007,65420
4923,4923,971,2007-04-19 19:38:00,Natalie Erin,1,2007,65421
4924,4924,972,2007-04-19 19:38:00,GunnarRene,-225,2007,65196
4925,4925,970,2007-04-19 19:40:00,Natalie Erin,23,2007,65219
4926,4926,969,2007-04-19 19:40:00,Efyoo,3,2007,65222
4927,4927,968,2007-04-19 19:42:00,Pepsidrinka,2,2007,65224
4928,4928,967,2007-04-19 19:42:00,Natalie Erin,-18,2007,65206
4929,4929,966,2007-04-19 19:42:00,RoyBoy,103,2007,65309
4930,4931,964,2007-04-19 19:43:00,Natalie Erin,-102,2007,65207
4931,4930,965,2007-04-19 19:43:00,RoyBoy,19,2007,65226
4932,4932,963,2007-04-19 19:44:00,RoyBoy,-107,2007,65119
4933,4933,962,2007-04-19 19:44:00,RoyBoy,96,2007,65215
4934,4934,960,2007-04-19 19:45:00,Natalie Erin,118,2007,65333
4935,4935,961,2007-04-19 19:45:00,GunnarRene,138,2007,65471
4936,4936,959,2007-04-19 19:46:00,RoyBoy,1,2007,65472
4937,4937,958,2007-04-19 19:49:00,Natalie Erin,236,2007,65708
4938,4938,957,2007-04-19 19:51:00,RoyBoy,0,2007,65708
4939,4939,956,2007-04-19 19:53:00,Rjk1541,2,2007,65710
4940,4940,955,2007-04-19 19:54:00,Natalie Erin,-44,2007,65666
4941,4941,954,2007-04-19 19:55:00,Natalie Erin,-5,2007,65661
4942,4942,953,2007-04-19 19:59:00,Seantpainter,-2,2007,65659
4943,4943,951,2007-04-19 20:03:00,Guat6,190,2007,65849
4944,4944,952,2007-04-19 20:03:00,Th1rt3en,1,2007,65850
4945,4945,950,2007-04-19 20:05:00,Natalie Erin,175,2007,66025
4946,4946,949,2007-04-19 20:12:00,Natalie Erin,-69,2007,65956
4947,4947,948,2007-04-19 20:13:00,Ronnotel,-20,2007,65936
4948,4948,947,2007-04-19 20:15:00,Natalie Erin,81,2007,66017
4949,4949,946,2007-04-19 20:17:00,Natalie Erin,-325,2007,65692
4950,4950,945,2007-04-19 20:19:00,Natalie Erin,159,2007,65851
4951,4951,944,2007-04-19 20:21:00,Sad mouse,92,2007,65943
4952,4953,943,2007-04-19 20:22:00,Natalie Erin,-163,2007,65780
4953,4952,942,2007-04-19 20:22:00,Zanimum,293,2007,66073
4954,4954,941,2007-04-19 20:23:00,Natalie Erin,35,2007,66108
4955,4955,940,2007-04-19 20:25:00,SmackBot,36,2007,66144
4956,4956,939,2007-04-19 20:26:00,Natalie Erin,181,2007,66325
4957,4957,938,2007-04-19 20:27:00,Markm62,-7,2007,66318
4958,4958,937,2007-04-19 20:29:00,Markm62,-13,2007,66305
4959,4959,936,2007-04-19 20:31:00,Natalie Erin,0,2007,66305
4960,4960,935,2007-04-19 20:32:00,Natalie Erin,92,2007,66397
4961,4962,934,2007-04-19 20:35:00,Markm62,-61,2007,66336
4962,4961,933,2007-04-19 20:35:00,Matt Gies,3,2007,66339
4963,4963,932,2007-04-19 20:36:00,Matt Gies,-1,2007,66338
4964,4964,931,2007-04-19 20:37:00,Natalie Erin,100,2007,66438
4965,4965,930,2007-04-19 20:39:00,Natalie Erin,159,2007,66597
4966,4966,929,2007-04-19 20:40:00,Markm62,-26,2007,66571
4967,4968,927,2007-04-19 20:41:00,Markm62,-85,2007,66486
4968,4967,928,2007-04-19 20:41:00,P.Shack,11,2007,66497
4969,4969,926,2007-04-19 20:42:00,Zehly,13,2007,66510
4970,4970,925,2007-04-19 20:43:00,The Future,85,2007,66595
4971,4971,924,2007-04-19 20:45:00,Ronnotel,7,2007,66602
4972,4972,922,2007-04-19 20:46:00,Yaf,-92,2007,66510
4973,4973,923,2007-04-19 20:46:00,Ronnotel,-7,2007,66503
4974,4974,921,2007-04-19 20:51:00,Oscarthecat,0,2007,66503
4975,4975,920,2007-04-19 20:53:00,Jared,46,2007,66549
4976,4976,919,2007-04-19 20:53:00,Wikipedian64,0,2007,66549
4977,4977,918,2007-04-19 20:54:00,Natalie Erin,0,2007,66549
4978,4978,917,2007-04-19 20:56:00,Statwizard,0,2007,66549
4979,4979,916,2007-04-19 20:58:00,Crosspire,221,2007,66770
4980,4980,915,2007-04-19 21:01:00,Crosspire,221,2007,66991
4981,4981,914,2007-04-19 21:01:00,Abe Lincoln,85,2007,67076
4982,4982,913,2007-04-19 21:06:00,Natalie Erin,0,2007,67076
4983,4983,912,2007-04-19 21:07:00,Pladuk,0,2007,67076
4984,4984,911,2007-04-19 21:08:00,Natalie Erin,19,2007,67095
4985,4985,910,2007-04-19 21:09:00,Natalie Erin,-55,2007,67040
4986,4986,909,2007-04-19 21:10:00,Natalie Erin,0,2007,67040
4987,4987,907,2007-04-19 21:11:00,Yaf,3,2007,67043
4988,4988,908,2007-04-19 21:11:00,Rexroad,-35,2007,67008
4989,4989,906,2007-04-19 21:13:00,Yaf,-29,2007,66979
4990,4990,905,2007-04-19 21:14:00,Rexroad,-27,2007,66952
4991,4991,904,2007-04-19 21:15:00,Tfine80,-307,2007,66645
4992,4992,903,2007-04-19 21:16:00,Yaf,1,2007,66646
4993,4993,902,2007-04-19 21:16:00,Rexroad,-66,2007,66580
4994,4994,901,2007-04-19 21:23:00,Natalie Erin,64,2007,66644
4995,4995,900,2007-04-19 21:25:00,Violask81976,-220,2007,66424
4996,4996,898,2007-04-19 21:26:00,Ferrett3,220,2007,66644
4997,4997,899,2007-04-19 21:26:00,Ferrett3,1,2007,66645
4998,4998,897,2007-04-19 21:30:00,Szyslak,-13,2007,66632
4999,4999,896,2007-04-19 21:33:00,RoyBoy,0,2007,66632
5000,5000,895,2007-04-19 21:33:00,Sicilianmandolin,-221,2007,66411
5001,5002,893,2007-04-19 21:35:00,Adraeus,54,2007,66465
5002,5001,894,2007-04-19 21:35:00,Sicilianmandolin,-221,2007,66244
5003,5003,892,2007-04-19 21:37:00,Scientz,-54,2007,66190
5004,5004,891,2007-04-19 21:37:00,Jambalaya~enwiki,-155,2007,66035
5005,5005,890,2007-04-19 21:48:00,Bobo The Ninja,19,2007,66054
5006,5006,889,2007-04-19 21:49:00,Bobo The Ninja,136,2007,66190
5007,5007,887,2007-04-19 21:58:00,Markie,0,2007,66190
5008,5008,888,2007-04-19 21:58:00,Markie,-57,2007,66133
5009,5009,886,2007-04-19 22:07:00,WhisperToMe,129,2007,66262
5010,5010,884,2007-04-19 22:17:00,Fvasconcellos,-2,2007,66260
5011,5011,885,2007-04-19 22:17:00,Aelffin,-1,2007,66259
5012,5012,883,2007-04-19 22:23:00,Fvasconcellos,38,2007,66297
5013,5013,882,2007-04-19 22:24:00,Markm62,-87,2007,66210
5014,5014,881,2007-04-19 22:30:00,Markm62,90,2007,66300
5015,5015,880,2007-04-19 22:32:00,Markm62,14,2007,66314
5016,5016,879,2007-04-19 22:34:00,Markm62,13,2007,66327
5017,5017,878,2007-04-19 22:35:00,Markm62,22,2007,66349
5018,5018,875,2007-04-19 22:36:00,Natalie Erin,-4,2007,66345
5019,5019,877,2007-04-19 22:36:00,Sad mouse,155,2007,66500
5020,5020,876,2007-04-19 22:36:00,Kizor,64,2007,66564
5021,5021,874,2007-04-19 22:37:00,Abe.Froman,11,2007,66575
5022,5022,873,2007-04-19 22:38:00,Adraeus,19,2007,66594
5023,5023,872,2007-04-19 22:38:00,Natalie Erin,1,2007,66595
5024,5024,871,2007-04-19 22:39:00,Adraeus,0,2007,66595
5025,5025,870,2007-04-19 22:40:00,Natalie Erin,-1,2007,66594
5026,5026,869,2007-04-19 22:41:00,Halo,22,2007,66616
5027,5027,868,2007-04-19 22:41:00,Natalie Erin,1,2007,66617
5028,5028,867,2007-04-19 22:41:00,Kizor,0,2007,66617
5029,5029,865,2007-04-19 22:42:00,Kizor,151,2007,66768
5030,5030,866,2007-04-19 22:42:00,Kizor,-256,2007,66512
5031,5031,864,2007-04-19 22:48:00,Markm62,-21,2007,66491
5032,5032,862,2007-04-19 22:49:00,Markm62,-12,2007,66479
5033,5033,863,2007-04-19 22:49:00,Scientz,246,2007,66725
5034,5034,861,2007-04-19 22:50:00,Zehly,13,2007,66738
5035,5035,860,2007-04-19 22:51:00,Markm62,12,2007,66750
5036,5036,859,2007-04-19 22:52:00,Kizor,38,2007,66788
5037,5037,858,2007-04-19 22:53:00,Markm62,-14,2007,66774
5038,5038,857,2007-04-19 22:53:00,Kizor,10,2007,66784
5039,5039,856,2007-04-19 22:55:00,Markm62,-5,2007,66779
5040,5040,855,2007-04-19 22:56:00,Halo,-2,2007,66777
5041,5041,854,2007-04-19 22:57:00,Sfmammamia,195,2007,66972
5042,5042,853,2007-04-19 22:58:00,Scientz,-27,2007,66945
5043,5043,852,2007-04-19 22:59:00,Sbrools,17,2007,66962
5044,5044,851,2007-04-19 22:59:00,Kaustuv,-13,2007,66949
5045,5045,850,2007-04-19 23:00:00,Chunky Rice,0,2007,66949
5046,5049,848,2007-04-19 23:02:00,Kizor,-326,2007,66623
5047,5048,849,2007-04-19 23:02:00,Halo,-200,2007,66423
5048,5046,846,2007-04-19 23:02:00,AntiSpamBot,-271,2007,66152
5049,5047,847,2007-04-19 23:02:00,Dubtrub93,271,2007,66423
5050,5050,845,2007-04-19 23:06:00,Dubtrub93,277,2007,66700
5051,5051,844,2007-04-19 23:08:00,De Administrando Imperio,-16,2007,66684
5052,5052,843,2007-04-19 23:09:00,Kizor,0,2007,66684
5053,5053,842,2007-04-19 23:09:00,Ward3001,-6,2007,66678
5054,5054,841,2007-04-19 23:09:00,De Administrando Imperio,-236,2007,66442
5055,5055,840,2007-04-19 23:09:00,Halo,-276,2007,66166
5056,5056,839,2007-04-19 23:10:00,Halo,-170,2007,65996
5057,5057,838,2007-04-19 23:11:00,SNIyer12,-187,2007,65809
5058,5059,837,2007-04-19 23:12:00,Yksin,187,2007,65996
5059,5058,836,2007-04-19 23:12:00,Jet7111,16,2007,66012
5060,5060,835,2007-04-19 23:13:00,SNIyer12,243,2007,66255
5061,5061,834,2007-04-19 23:14:00,Jet7111,13,2007,66268
5062,5062,833,2007-04-19 23:14:00,69.116.24.255,1,2007,66269
5063,5063,832,2007-04-19 23:15:00,68.61.133.31,-2,2007,66267
5064,5064,831,2007-04-19 23:16:00,68.61.133.31,3,2007,66270
5065,5065,830,2007-04-19 23:17:00,69.249.52.250,2,2007,66272
5066,5066,829,2007-04-19 23:17:00,Kaustuv,9,2007,66281
5067,5067,828,2007-04-19 23:18:00,Scientz,0,2007,66281
5068,5068,827,2007-04-19 23:19:00,Yksin,0,2007,66281
5069,5069,826,2007-04-19 23:20:00,Kizor,0,2007,66281
5070,5070,825,2007-04-19 23:21:00,Scientz,-26,2007,66255
5071,5071,824,2007-04-19 23:24:00,Chaerani,462,2007,66717
5072,5072,823,2007-04-19 23:26:00,Halo,0,2007,66717
5073,5073,822,2007-04-19 23:28:00,66.32.60.102,4,2007,66721
5074,5074,821,2007-04-19 23:29:00,Intgr,4,2007,66725
5075,5075,820,2007-04-19 23:30:00,65.2.140.195,-33,2007,66692
5076,5076,819,2007-04-19 23:31:00,Yamamoto Ichiro,33,2007,66725
5077,5077,818,2007-04-19 23:32:00,71.254.75.88,0,2007,66725
5078,5078,817,2007-04-19 23:32:00,MartinBot,0,2007,66725
5079,5079,816,2007-04-19 23:34:00,SchirmerPower,4,2007,66729
5080,5080,815,2007-04-19 23:35:00,Ikilled007,7,2007,66736
5081,5081,814,2007-04-19 23:36:00,Ikilled007,5,2007,66741
5082,5082,813,2007-04-19 23:37:00,Sfmammamia,265,2007,67006
5083,5083,812,2007-04-19 23:38:00,Sfmammamia,-30,2007,66976
5084,5084,811,2007-04-19 23:39:00,Ward3001,-93,2007,66883
5085,5085,810,2007-04-19 23:40:00,Mratzloff,-17,2007,66866
5086,5086,809,2007-04-20 00:00:00,ElKevbo,26,2007,66892
5087,5087,808,2007-04-20 00:02:00,Mratzloff,31,2007,66923
5088,5088,807,2007-04-20 00:02:00,Jet7111,4,2007,66927
5089,5089,806,2007-04-20 00:03:00,ElKevbo,-194,2007,66733
5090,5090,805,2007-04-20 00:05:00,Lexein,13,2007,66746
5091,5091,804,2007-04-20 00:07:00,Jimmi Hugh,-4,2007,66742
5092,5092,803,2007-04-20 00:08:00,131.247.221.126,-29,2007,66713
5093,5093,802,2007-04-20 00:11:00,Mratzloff,16,2007,66729
5094,5094,801,2007-04-20 00:12:00,204.52.215.98,17,2007,66746
5095,5095,800,2007-04-20 00:13:00,204.52.215.98,-17,2007,66729
5096,5096,799,2007-04-20 00:17:00,Ronnotel,0,2007,66729
5097,5097,798,2007-04-20 00:19:00,Hanako,34,2007,66763
5098,5098,797,2007-04-20 00:20:00,Mratzloff,-141,2007,66622
5099,5099,796,2007-04-20 00:20:00,Jet7111,-4,2007,66618
5100,5100,795,2007-04-20 00:20:00,Gdo01,107,2007,66725
5101,5101,794,2007-04-20 00:29:00,Mratzloff,12,2007,66737
5102,5102,793,2007-04-20 00:30:00,Mratzloff,-133,2007,66604
5103,5103,792,2007-04-20 00:33:00,Darrik2,-2,2007,66602
5104,5104,791,2007-04-20 00:37:00,209.82.26.66,72,2007,66674
5105,5105,790,2007-04-20 00:38:00,70.128.59.2,35,2007,66709
5106,5106,789,2007-04-20 00:39:00,Gdo01,-35,2007,66674
5107,5107,788,2007-04-20 00:40:00,Gdo01,-72,2007,66602
5108,5108,787,2007-04-20 00:40:00,Sfmammamia,-90,2007,66512
5109,5109,786,2007-04-20 00:40:00,68.197.8.5,-12,2007,66500
5110,5110,785,2007-04-20 00:41:00,209.82.26.66,12,2007,66512
5111,5111,784,2007-04-20 00:42:00,209.82.26.66,4,2007,66516
5112,5112,783,2007-04-20 00:43:00,Johnnyd1980,0,2007,66516
5113,5113,782,2007-04-20 00:44:00,68.101.148.91,2,2007,66518
5114,5115,781,2007-04-20 00:45:00,Gdo01,-2,2007,66516
5115,5114,780,2007-04-20 00:45:00,209.82.26.66,0,2007,66516
5116,5116,779,2007-04-20 00:46:00,Gdo01,2,2007,66518
5117,5117,778,2007-04-20 00:47:00,Mahanga,2,2007,66520
5118,5118,777,2007-04-20 00:50:00,68.175.118.95,10,2007,66530
5119,5119,776,2007-04-20 00:52:00,MCalamari,4,2007,66534
5120,5120,775,2007-04-20 00:54:00,209.82.26.66,13,2007,66547
5121,5121,774,2007-04-20 00:55:00,209.82.26.66,-3,2007,66544
5122,5122,773,2007-04-20 00:55:00,Gdo01,-10,2007,66534
5123,5124,771,2007-04-20 00:56:00,Antandrus,0,2007,66534
5124,5123,772,2007-04-20 00:56:00,66.60.216.33,0,2007,66534
5125,5125,770,2007-04-20 00:57:00,69.204.237.72,30,2007,66564
5126,5126,769,2007-04-20 00:58:00,Zzuuzz,-30,2007,66534
5127,5127,768,2007-04-20 01:00:00,209.82.26.66,-22,2007,66512
5128,5128,767,2007-04-20 01:01:00,Goodnightmush,22,2007,66534
5129,5129,766,2007-04-20 01:01:00,Homelien,4,2007,66538
5130,5130,765,2007-04-20 01:02:00,70.58.15.209,0,2007,66538
5131,5131,764,2007-04-20 01:02:00,MartinBot,0,2007,66538
5132,5132,763,2007-04-20 01:03:00,70.58.15.209,0,2007,66538
5133,5133,762,2007-04-20 01:03:00,Gdo01,0,2007,66538
5134,5134,761,2007-04-20 01:09:00,74.234.109.170,0,2007,66538
5135,5135,760,2007-04-20 01:10:00,Coemgenus,0,2007,66538
5136,5136,759,2007-04-20 01:15:00,Yksin,0,2007,66538
5137,5137,758,2007-04-20 01:18:00,71.166.110.56,51,2007,66589
5138,5138,757,2007-04-20 01:19:00,Scientizzle,-51,2007,66538
5139,5139,756,2007-04-20 01:19:00,UBeR,-7,2007,66531
5140,5140,755,2007-04-20 01:22:00,UBeR,-8,2007,66523
5141,5141,754,2007-04-20 01:23:00,DeusMP,4,2007,66527
5142,5142,753,2007-04-20 01:24:00,Kizor,245,2007,66772
5143,5143,752,2007-04-20 01:26:00,67.83.99.108,-2,2007,66770
5144,5144,751,2007-04-20 01:26:00,Gdo01,2,2007,66772
5145,5145,750,2007-04-20 01:27:00,Mukadark,67,2007,66839
5146,5146,749,2007-04-20 01:28:00,Retired username,-67,2007,66772
5147,5147,748,2007-04-20 01:29:00,RoyBoy,-245,2007,66527
5148,5148,747,2007-04-20 01:30:00,RoyBoy,6,2007,66533
5149,5149,746,2007-04-20 01:31:00,RoyBoy,-4,2007,66529
5150,5150,745,2007-04-20 01:33:00,RoyBoy,-1,2007,66528
5151,5152,743,2007-04-20 01:36:00,Jimmi Hugh,-46,2007,66482
5152,5151,744,2007-04-20 01:36:00,67.183.44.210,46,2007,66528
5153,5153,742,2007-04-20 01:38:00,70.128.59.2,129,2007,66657
5154,5154,741,2007-04-20 01:39:00,Gdo01,-129,2007,66528
5155,5155,740,2007-04-20 01:42:00,Mwtoews,-55,2007,66473
5156,5156,739,2007-04-20 01:49:00,72.187.47.132,180,2007,66653
5157,5157,738,2007-04-20 01:51:00,Gdo01,-180,2007,66473
5158,5158,737,2007-04-20 01:54:00,130.95.106.154,38,2007,66511
5159,5159,736,2007-04-20 01:56:00,Gdo01,-38,2007,66473
5160,5160,735,2007-04-20 01:58:00,68.40.254.194,216,2007,66689
5161,5161,734,2007-04-20 02:03:00,64.203.191.158,1,2007,66690
5162,5162,733,2007-04-20 02:10:00,24.223.176.173,29,2007,66719
5163,5163,732,2007-04-20 02:11:00,Mhking,-29,2007,66690
5164,5164,731,2007-04-20 02:12:00,24.223.176.173,14,2007,66704
5165,5165,730,2007-04-20 02:13:00,LuigiManiac,-14,2007,66690
5166,5166,729,2007-04-20 02:14:00,24.223.176.173,0,2007,66690
5167,5167,728,2007-04-20 02:14:00,MartinBot,0,2007,66690
5168,5168,727,2007-04-20 02:16:00,24.223.176.173,0,2007,66690
5169,5169,725,2007-04-20 02:18:00,MartinBot,-15,2007,66675
5170,5170,724,2007-04-20 02:18:00,LuigiManiac,0,2007,66675
5171,5171,726,2007-04-20 02:18:00,68.165.58.114,15,2007,66690
5172,5172,723,2007-04-20 02:23:00,74.166.21.114,85,2007,66775
5173,5176,719,2007-04-20 02:24:00,LuigiManiac,-425,2007,66350
5174,5175,720,2007-04-20 02:24:00,Kntrabssi,399,2007,66749
5175,5173,722,2007-04-20 02:24:00,Fang Teng,0,2007,66749
5176,5174,721,2007-04-20 02:24:00,69.253.39.85,26,2007,66775
5177,5177,717,2007-04-20 02:25:00,Mhking,399,2007,67174
5178,5178,716,2007-04-20 02:26:00,Fang Teng,0,2007,67174
5179,5179,715,2007-04-20 02:27:00,Fang Teng,0,2007,67174
5180,5180,714,2007-04-20 02:34:00,Titanium Dragon,0,2007,67174
5181,5181,713,2007-04-20 02:35:00,68.217.125.126,150,2007,67324
5182,5182,712,2007-04-20 02:35:00,Gdo01,-150,2007,67174
5183,5183,711,2007-04-20 02:39:00,JoshuaZ,193,2007,67367
5184,5185,709,2007-04-20 02:44:00,Gdo01,-9,2007,67358
5185,5184,710,2007-04-20 02:44:00,75.8.60.237,9,2007,67367
5186,5186,708,2007-04-20 02:47:00,71.57.130.161,370,2007,67737
5187,5187,707,2007-04-20 02:48:00,71.57.130.161,-3,2007,67734
5188,5188,706,2007-04-20 02:48:00,75.8.60.237,146,2007,67880
5189,5189,705,2007-04-20 02:49:00,Natalie Erin,-371,2007,67509
5190,5190,704,2007-04-20 02:49:00,Natalie Erin,2,2007,67511
5191,5191,703,2007-04-20 02:50:00,Gdo01,-144,2007,67367
5192,5192,701,2007-04-20 02:51:00,Nivix,-156,2007,67211
5193,5193,702,2007-04-20 02:51:00,75.8.60.237,156,2007,67367
5194,5194,700,2007-04-20 02:57:00,75.8.60.237,156,2007,67523
5195,5195,699,2007-04-20 02:57:00,Nivix,-156,2007,67367
5196,5197,697,2007-04-20 03:15:00,Nivix,-42,2007,67325
5197,5196,698,2007-04-20 03:15:00,24.252.98.145,42,2007,67367
5198,5199,695,2007-04-20 03:16:00,Nivix,-17,2007,67350
5199,5198,696,2007-04-20 03:16:00,68.193.205.213,17,2007,67367
5200,5200,694,2007-04-20 03:17:00,75.31.104.107,-5,2007,67362
5201,5201,693,2007-04-20 03:19:00,70.57.163.140,134,2007,67496
5202,5202,691,2007-04-20 03:20:00,Gdo01,-133,2007,67363
5203,5203,692,2007-04-20 03:20:00,70.57.163.140,-1,2007,67362
5204,5204,689,2007-04-20 03:27:00,Nivix,-228,2007,67134
5205,5205,690,2007-04-20 03:27:00,208.59.162.51,228,2007,67362
5206,5206,688,2007-04-20 03:28:00,208.59.162.51,0,2007,67362
5207,5207,687,2007-04-20 03:28:00,Gdo01,0,2007,67362
5208,5208,686,2007-04-20 03:32:00,74.60.216.53,28,2007,67390
5209,5211,683,2007-04-20 03:33:00,69.143.106.99,0,2007,67390
5210,5210,684,2007-04-20 03:33:00,24.255.184.74,163,2007,67553
5211,5209,685,2007-04-20 03:33:00,Nivix,-28,2007,67525
5212,5212,680,2007-04-20 03:34:00,Retro1983,2,2007,67527
5213,5213,682,2007-04-20 03:34:00,Ixfd64,0,2007,67527
5214,5214,681,2007-04-20 03:34:00,Gdo01,-163,2007,67364
5215,5215,679,2007-04-20 03:35:00,Gdo01,-2,2007,67362
5216,5216,678,2007-04-20 03:37:00,Fsotrain09,0,2007,67362
5217,5217,677,2007-04-20 03:43:00,168.103.120.202,0,2007,67362
5218,5218,676,2007-04-20 03:44:00,Randalllin,0,2007,67362
5219,5219,675,2007-04-20 03:44:00,70.68.212.71,0,2007,67362
5220,5220,674,2007-04-20 03:44:00,Nivix,0,2007,67362
5221,5222,672,2007-04-20 03:46:00,Nivix,-62,2007,67300
5222,5221,673,2007-04-20 03:46:00,64.229.12.189,62,2007,67362
5223,5223,671,2007-04-20 03:47:00,B,0,2007,67362
5224,5224,670,2007-04-20 03:48:00,B,16,2007,67378
5225,5225,669,2007-04-20 03:59:00,RLM1961,320,2007,67698
5226,5226,668,2007-04-20 04:02:00,Loren36,-320,2007,67378
5227,5227,667,2007-04-20 04:13:00,Curtis~enwiki,226,2007,67604
5228,5228,666,2007-04-20 04:32:00,Vsion,291,2007,67895
5229,5229,665,2007-04-20 04:48:00,Fbv65edel,5,2007,67900
5230,5230,664,2007-04-20 04:58:00,Chrishmt0423,-2,2007,67898
5231,5231,663,2007-04-20 04:58:00,Mark Sublette,7,2007,67905
5232,5232,662,2007-04-20 05:04:00,Mark Sublette,168,2007,68073
5233,5233,661,2007-04-20 05:05:00,Mark Sublette,0,2007,68073
5234,5234,660,2007-04-20 05:10:00,ElKevbo,-169,2007,67904
5235,5235,659,2007-04-20 05:25:00,Pinotgris,1,2007,67905
5236,5236,658,2007-04-20 05:58:00,Dvd2056,-4,2007,67901
5237,5237,657,2007-04-20 06:04:00,Dhartung,22,2007,67923
5238,5238,656,2007-04-20 06:05:00,Uthbrian,0,2007,67923
5239,5239,654,2007-04-20 06:06:00,Gdo01,0,2007,67923
5240,5240,653,2007-04-20 06:09:00,Uthbrian,-4,2007,67919
5241,5241,652,2007-04-20 06:10:00,Dhartung,445,2007,68364
5242,5242,651,2007-04-20 06:13:00,Ralph Robbins,0,2007,68364
5243,5243,650,2007-04-20 06:16:00,ElKevbo,0,2007,68364
5244,5244,649,2007-04-20 06:19:00,AF985,0,2007,68364
5245,5245,648,2007-04-20 06:20:00,Gdo01,0,2007,68364
5246,5246,647,2007-04-20 06:30:00,AF985,0,2007,68364
5247,5247,646,2007-04-20 06:34:00,Mingus19,7,2007,68371
5248,5248,645,2007-04-20 06:39:00,John Stattic,-14,2007,68357
5249,5249,644,2007-04-20 06:41:00,Gotcalcio4,-7,2007,68350
5250,5250,643,2007-04-20 06:44:00,Yaf,-32,2007,68318
5251,5251,642,2007-04-20 06:46:00,Yaf,-155,2007,68163
5252,5252,641,2007-04-20 06:48:00,Yaf,-290,2007,67873
5253,5253,640,2007-04-20 06:55:00,Abe Lincoln,85,2007,67958
5254,5254,639,2007-04-20 07:27:00,Dputig07,225,2007,68183
5255,5255,638,2007-04-20 07:28:00,Dputig07,46,2007,68229
5256,5256,637,2007-04-20 07:33:00,Faded,193,2007,68422
5257,5257,636,2007-04-20 07:54:00,Sina22,79,2007,68501
5258,5258,635,2007-04-20 08:07:00,JavaTenor,-79,2007,68422
5259,5259,634,2007-04-20 10:21:00,Cherylyoung,127,2007,68549
5260,5260,633,2007-04-20 10:22:00,Cherylyoung,-1,2007,68548
5261,5261,632,2007-04-20 10:25:00,Cherylyoung,53,2007,68601
5262,5262,631,2007-04-20 10:34:00,Rich Farmbrough,11,2007,68612
5263,5263,630,2007-04-20 10:35:00,Rich Farmbrough,5,2007,68617
5264,5264,629,2007-04-20 10:37:00,Rich Farmbrough,-4,2007,68613
5265,5265,628,2007-04-20 10:39:00,Rich Farmbrough,-4,2007,68609
5266,5266,627,2007-04-20 10:48:00,Smokefan2007,-13,2007,68596
5267,5267,626,2007-04-20 11:01:00,Supergeo,-1,2007,68595
5268,5268,625,2007-04-20 11:19:00,StuffOfInterest,27,2007,68622
5269,5269,624,2007-04-20 11:30:00,Tmkain,0,2007,68622
5270,5270,623,2007-04-20 11:54:00,Zuejay,0,2007,68622
5271,5271,622,2007-04-20 12:11:00,Kizor,240,2007,68862
5272,5272,621,2007-04-20 12:13:00,Kizor,21,2007,68883
5273,5273,620,2007-04-20 12:49:00,Nyttend,0,2007,68883
5274,5274,618,2007-04-20 12:55:00,MartinBot,0,2007,68883
5275,5275,619,2007-04-20 12:55:00,66.238.170.39,0,2007,68883
5276,5276,617,2007-04-20 13:07:00,B,-16,2007,68867
5277,5277,616,2007-04-20 13:19:00,Shmaller,12,2007,68879
5278,5278,615,2007-04-20 13:26:00,212.219.80.200,26,2007,68905
5279,5279,614,2007-04-20 13:27:00,Retired username,-26,2007,68879
5280,5280,613,2007-04-20 13:28:00,ElKevbo,0,2007,68879
5281,5281,612,2007-04-20 13:28:00,B,-12,2007,68867
5282,5282,611,2007-04-20 13:30:00,JediLofty,249,2007,69116
5283,5283,610,2007-04-20 13:42:00,129.170.29.111,0,2007,69116
5284,5284,609,2007-04-20 13:45:00,FrstFrs,-2,2007,69114
5285,5285,607,2007-04-20 13:46:00,Npatwari,14,2007,69128
5286,5286,608,2007-04-20 13:46:00,Ronnotel,-247,2007,68881
5287,5287,606,2007-04-20 13:47:00,Npatwari,249,2007,69130
5288,5288,605,2007-04-20 13:50:00,Ronnotel,-62,2007,69068
5289,5289,604,2007-04-20 13:54:00,155.94.62.221,-31,2007,69037
5290,5292,601,2007-04-20 13:55:00,Ronnotel,-1,2007,69036
5291,5290,603,2007-04-20 13:55:00,12.160.58.83,0,2007,69036
5292,5291,602,2007-04-20 13:55:00,Ronnotel,0,2007,69036
5293,5293,600,2007-04-20 14:01:00,Joetheguy,436,2007,69472
5294,5294,599,2007-04-20 14:01:00,Ronnotel,-247,2007,69225
5295,5295,597,2007-04-20 14:07:00,Zehly,13,2007,69238
5296,5296,598,2007-04-20 14:07:00,68.55.204.182,9,2007,69247
5297,5297,596,2007-04-20 14:11:00,Abe Lincoln,0,2007,69247
5298,5298,595,2007-04-20 14:13:00,Jared,-1,2007,69246
5299,5299,594,2007-04-20 14:15:00,Jared,-13,2007,69233
5300,5300,593,2007-04-20 14:15:00,Jared,-62,2007,69171
5301,5301,592,2007-04-20 14:16:00,Kaustuv,-13,2007,69158
5302,5303,590,2007-04-20 14:20:00,Jhvillegas2,10,2007,69168
5303,5302,591,2007-04-20 14:20:00,Ronnotel,-9,2007,69159
5304,5304,589,2007-04-20 14:21:00,Ronnotel,16,2007,69175
5305,5305,587,2007-04-20 14:21:00,Ronnotel,-16,2007,69159
5306,5306,586,2007-04-20 14:22:00,Jared,0,2007,69159
5307,5307,585,2007-04-20 14:23:00,Kaustuv,-10,2007,69149
5308,5308,584,2007-04-20 14:24:00,Abe Lincoln,12,2007,69161
5309,5309,583,2007-04-20 14:25:00,Zehly,13,2007,69174
5310,5310,582,2007-04-20 14:27:00,Kaustuv,-13,2007,69161
5311,5311,581,2007-04-20 14:32:00,Kransky,395,2007,69556
5312,5312,580,2007-04-20 14:32:00,Kransky,1,2007,69557
5313,5315,577,2007-04-20 14:37:00,ElKevbo,2,2007,69559
5314,5313,579,2007-04-20 14:37:00,ElKevbo,13,2007,69572
5315,5314,578,2007-04-20 14:37:00,129.71.208.52,0,2007,69572
5316,5316,574,2007-04-20 14:38:00,129.71.208.52,-28,2007,69544
5317,5317,575,2007-04-20 14:38:00,129.71.208.52,0,2007,69544
5318,5318,573,2007-04-20 14:39:00,Whiskey in the Jar,0,2007,69544
5319,5319,572,2007-04-20 14:39:00,Jared,28,2007,69572
5320,5320,571,2007-04-20 14:40:00,Jared,0,2007,69572
5321,5321,570,2007-04-20 14:44:00,Dleav,-7,2007,69565
5322,5322,569,2007-04-20 14:50:00,193.95.159.66,1,2007,69566
5323,5323,568,2007-04-20 14:51:00,Dingbat22,6,2007,69572
5324,5324,567,2007-04-20 15:21:00,Tregoweth,-262,2007,69310
5325,5325,566,2007-04-20 15:23:00,82.6.27.23,2,2007,69312
5326,5326,565,2007-04-20 15:29:00,FeanorStar7,3,2007,69315
5327,5327,564,2007-04-20 15:30:00,Crosspire,0,2007,69315
5328,5328,563,2007-04-20 15:32:00,64.129.24.11,75,2007,69390
5329,5329,562,2007-04-20 15:32:00,Crosspire,141,2007,69531
5330,5330,561,2007-04-20 15:33:00,LuigiManiac,-141,2007,69390
5331,5331,560,2007-04-20 15:34:00,Jeeny,0,2007,69390
5332,5332,559,2007-04-20 15:39:00,Coemgenus,6,2007,69396
5333,5333,558,2007-04-20 15:39:00,Jeeny,-2,2007,69394
5334,5334,556,2007-04-20 15:40:00,HokieRNB,-26,2007,69368
5335,5335,557,2007-04-20 15:40:00,Coemgenus,3,2007,69371
5336,5336,555,2007-04-20 15:41:00,HokieRNB,-8,2007,69363
5337,5337,554,2007-04-20 15:44:00,HokieRNB,-331,2007,69032
5338,5338,553,2007-04-20 15:51:00,86.56.48.12,-55,2007,68977
5339,5339,552,2007-04-20 15:53:00,168.213.7.64,-55,2007,68922
5340,5340,551,2007-04-20 15:53:00,Kukini,55,2007,68977
5341,5341,550,2007-04-20 15:56:00,86.56.48.12,-6,2007,68971
5342,5342,549,2007-04-20 15:59:00,199.17.56.135,-39,2007,68932
5343,5343,548,2007-04-20 15:59:00,Dputig07,0,2007,68932
5344,5344,546,2007-04-20 16:00:00,Jeeny,13,2007,68945
5345,5345,547,2007-04-20 16:00:00,ElKevbo,19,2007,68964
5346,5346,545,2007-04-20 16:02:00,Sad mouse,149,2007,69113
5347,5349,544,2007-04-20 16:03:00,Armanikid,4,2007,69117
5348,5347,543,2007-04-20 16:03:00,Danski14,39,2007,69156
5349,5348,542,2007-04-20 16:03:00,Danski14,-4,2007,69152
5350,5350,541,2007-04-20 16:04:00,216.186.31.30,29,2007,69181
5351,5351,540,2007-04-20 16:07:00,80.61.166.174,9,2007,69190
5352,5352,539,2007-04-20 16:07:00,80.61.166.174,1,2007,69191
5353,5353,538,2007-04-20 16:13:00,Jeeny,-11,2007,69180
5354,5354,537,2007-04-20 16:20:00,65.214.112.56,298,2007,69478
5355,5355,535,2007-04-20 16:21:00,65.214.112.56,-1,2007,69477
5356,5356,536,2007-04-20 16:21:00,65.214.112.56,-5,2007,69472
5357,5357,533,2007-04-20 16:22:00,Thebanjohype,5,2007,69477
5358,5358,532,2007-04-20 16:22:00,ElKevbo,-4,2007,69473
5359,5359,531,2007-04-20 16:23:00,ElKevbo,-4,2007,69469
5360,5360,529,2007-04-20 16:25:00,ElKevbo,0,2007,69469
5361,5361,528,2007-04-20 16:26:00,65.214.112.56,163,2007,69632
5362,5362,527,2007-04-20 16:27:00,ElKevbo,1,2007,69633
5363,5363,526,2007-04-20 16:28:00,ElKevbo,1,2007,69634
5364,5364,525,2007-04-20 16:29:00,65.214.112.56,-100,2007,69534
5365,5365,524,2007-04-20 16:32:00,Anubis2003,-29,2007,69505
5366,5366,523,2007-04-20 16:34:00,MoodyGroove,205,2007,69710
5367,5367,522,2007-04-20 16:36:00,Fizbin,-124,2007,69586
5368,5368,521,2007-04-20 16:38:00,The Letter J,1,2007,69587
5369,5369,520,2007-04-20 16:43:00,ElKevbo,226,2007,69813
5370,5371,518,2007-04-20 16:44:00,Rooot,32,2007,69845
5371,5370,519,2007-04-20 16:44:00,63.160.254.113,156,2007,70001
5372,5372,517,2007-04-20 16:46:00,63.160.254.113,0,2007,70001
5373,5373,516,2007-04-20 16:47:00,DerHexer,0,2007,70001
5374,5374,515,2007-04-20 16:47:00,89.54.53.203,0,2007,70001
5375,5375,514,2007-04-20 16:47:00,64.26.116.204,-156,2007,69845
5376,5376,511,2007-04-20 16:48:00,Pupster21,0,2007,69845
5377,5377,512,2007-04-20 16:48:00,89.54.53.203,0,2007,69845
5378,5378,510,2007-04-20 16:53:00,Adambro,59,2007,69904
5379,5379,509,2007-04-20 16:56:00,Adambro,5,2007,69909
5380,5380,508,2007-04-20 16:57:00,Worldanh,90,2007,69999
5381,5381,507,2007-04-20 17:02:00,Worldanh,90,2007,70089
5382,5383,505,2007-04-20 17:03:00,Nivix,0,2007,70089
5383,5382,506,2007-04-20 17:03:00,170.158.236.127,0,2007,70089
5384,5384,504,2007-04-20 17:04:00,Worldanh,0,2007,70089
5385,5385,501,2007-04-20 17:11:00,130.126.203.146,-28,2007,70061
5386,5386,503,2007-04-20 17:11:00,130.126.203.146,0,2007,70061
5387,5387,502,2007-04-20 17:11:00,DerHexer,0,2007,70061
5388,5388,500,2007-04-20 17:12:00,130.126.203.146,0,2007,70061
5389,5389,499,2007-04-20 17:12:00,Kukini,0,2007,70061
5390,5390,498,2007-04-20 17:14:00,137.22.118.130,2,2007,70063
5391,5391,497,2007-04-20 17:14:00,Kukini,-2,2007,70061
5392,5392,496,2007-04-20 17:16:00,137.22.118.130,2,2007,70063
5393,5393,495,2007-04-20 17:16:00,Kukini,-2,2007,70061
5394,5394,494,2007-04-20 17:19:00,63.230.90.4,13,2007,70074
5395,5395,493,2007-04-20 17:27:00,Halo,-32,2007,70042
5396,5396,492,2007-04-20 17:31:00,Rooot,32,2007,70074
5397,5397,491,2007-04-20 17:32:00,165.138.192.9,7,2007,70081
5398,5398,490,2007-04-20 17:33:00,Halo,222,2007,70303
5399,5399,489,2007-04-20 17:34:00,Halo,-132,2007,70171
5400,5400,488,2007-04-20 17:35:00,165.138.192.9,34,2007,70205
5401,5401,487,2007-04-20 17:37:00,Halo,0,2007,70205
5402,5402,486,2007-04-20 17:38:00,LuigiManiac,-34,2007,70171
5403,5403,485,2007-04-20 17:42:00,80.43.109.255,33,2007,70204
5404,5404,484,2007-04-20 17:47:00,165.138.192.9,34,2007,70238
5405,5408,480,2007-04-20 17:48:00,LuigiManiac,-9,2007,70229
5406,5407,481,2007-04-20 17:48:00,Markm62,-25,2007,70204
5407,5406,482,2007-04-20 17:48:00,Antandrus,-1,2007,70203
5408,5405,483,2007-04-20 17:48:00,209.7.246.70,1,2007,70204
5409,5409,479,2007-04-20 17:49:00,Markm62,-84,2007,70120
5410,5410,478,2007-04-20 17:50:00,130.101.116.158,-105,2007,70015
5411,5411,476,2007-04-20 17:51:00,Darrik2,4,2007,70019
5412,5412,477,2007-04-20 17:51:00,165.138.192.9,9,2007,70028
5413,5413,475,2007-04-20 17:51:00,209.7.246.70,3,2007,70031
5414,5414,474,2007-04-20 17:52:00,Markm62,11,2007,70042
5415,5415,473,2007-04-20 17:55:00,LuigiManiac,-3,2007,70039
5416,5419,470,2007-04-20 17:57:00,Cherylyoung,187,2007,70226
5417,5418,471,2007-04-20 17:57:00,162.70.54.99,404,2007,70630
5418,5416,469,2007-04-20 17:57:00,Markm62,42,2007,70672
5419,5417,472,2007-04-20 17:57:00,Garas,-1,2007,70671
5420,5420,468,2007-04-20 17:58:00,162.70.54.99,4,2007,70675
5421,5421,467,2007-04-20 17:58:00,Abe Lincoln,84,2007,70759
5422,5422,466,2007-04-20 18:00:00,162.70.54.99,0,2007,70759
5423,5423,465,2007-04-20 18:02:00,162.70.54.99,3,2007,70762
5424,5424,464,2007-04-20 18:05:00,162.70.54.99,296,2007,71058
5425,5427,463,2007-04-20 18:06:00,162.70.54.99,1,2007,71059
5426,5425,461,2007-04-20 18:06:00,JoshuaZ,169,2007,71228
5427,5426,462,2007-04-20 18:06:00,Markm62,34,2007,71262
5428,5429,459,2007-04-20 18:07:00,JoshuaZ,-6,2007,71256
5429,5428,460,2007-04-20 18:07:00,Markm62,1,2007,71257
5430,5430,458,2007-04-20 18:08:00,Markm62,7,2007,71264
5431,5431,457,2007-04-20 18:08:00,70.129.61.226,149,2007,71413
5432,5432,456,2007-04-20 18:08:00,Markm62,-2,2007,71411
5433,5433,454,2007-04-20 18:09:00,162.70.54.99,19,2007,71430
5434,5434,455,2007-04-20 18:09:00,JoshuaZ,8,2007,71438
5435,5435,452,2007-04-20 18:10:00,Armanikid,-19,2007,71419
5436,5436,453,2007-04-20 18:10:00,Armanikid,4,2007,71423
5437,5437,449,2007-04-20 18:11:00,Vodak,27,2007,71450
5438,5438,451,2007-04-20 18:11:00,168.18.81.66,-149,2007,71301
5439,5439,450,2007-04-20 18:11:00,Armanikid,2,2007,71303
5440,5441,447,2007-04-20 18:12:00,LuigiManiac,-3,2007,71300
5441,5440,448,2007-04-20 18:12:00,209.7.246.70,3,2007,71303
5442,5442,446,2007-04-20 18:14:00,JoshuaZ,-3,2007,71300
5443,5443,445,2007-04-20 18:14:00,JoshuaZ,3,2007,71303
5444,5444,444,2007-04-20 18:17:00,162.70.54.99,-22,2007,71281
5445,5445,443,2007-04-20 18:22:00,131.25.245.4,-2,2007,71279
5446,5446,442,2007-04-20 18:32:00,Halo,68,2007,71347
5447,5447,441,2007-04-20 18:33:00,Halo,-1,2007,71346
5448,5448,440,2007-04-20 18:44:00,Chrishmt0423,51,2007,71397
5449,5449,439,2007-04-20 18:44:00,206.192.18.14,0,2007,71397
5450,5450,438,2007-04-20 18:45:00,65.214.112.56,106,2007,71503
5451,5452,436,2007-04-20 18:46:00,12.96.202.201,186,2007,71689
5452,5451,437,2007-04-20 18:46:00,65.214.112.56,-1,2007,71688
5453,5453,435,2007-04-20 18:50:00,Markm62,27,2007,71715
5454,5454,434,2007-04-20 18:56:00,128.173.44.189,-1,2007,71714
5455,5455,433,2007-04-20 18:59:00,Natalie Erin,-1,2007,71713
5456,5456,432,2007-04-20 19:00:00,Slyguy,2,2007,71715
5457,5457,431,2007-04-20 19:01:00,Sfmammamia,-39,2007,71676
5458,5458,430,2007-04-20 19:02:00,Natalie Erin,-28,2007,71648
5459,5459,429,2007-04-20 19:04:00,Natalie Erin,-5,2007,71643
5460,5460,428,2007-04-20 19:07:00,Sfmammamia,9,2007,71652
5461,5462,427,2007-04-20 19:16:00,Supergeo,16,2007,71668
5462,5461,426,2007-04-20 19:16:00,Supergeo,-16,2007,71652
5463,5463,425,2007-04-20 19:21:00,StuffOfInterest,27,2007,71679
5464,5464,424,2007-04-20 19:22:00,Sfmammamia,-28,2007,71651
5465,5465,423,2007-04-20 19:29:00,Teka522001,0,2007,71651
5466,5466,422,2007-04-20 19:32:00,ElKevbo,0,2007,71651
5467,5467,421,2007-04-20 19:33:00,Bambamfan91,4,2007,71655
5468,5468,420,2007-04-20 19:34:00,82.82.85.1,0,2007,71655
5469,5469,419,2007-04-20 19:35:00,ElKevbo,59,2007,71714
5470,5470,418,2007-04-20 19:38:00,ElKevbo,27,2007,71741
5471,5471,417,2007-04-20 19:41:00,Zehly,-189,2007,71552
5472,5472,416,2007-04-20 19:42:00,169.229.73.166,332,2007,71884
5473,5473,415,2007-04-20 19:43:00,169.229.73.166,28,2007,71912
5474,5475,413,2007-04-20 19:46:00,Sfmammamia,-332,2007,71580
5475,5474,414,2007-04-20 19:46:00,169.229.73.166,20,2007,71600
5476,5476,412,2007-04-20 19:50:00,68.33.211.245,0,2007,71600
5477,5477,411,2007-04-20 19:51:00,Sfmammamia,0,2007,71600
5478,5478,410,2007-04-20 19:52:00,68.250.189.233,-16,2007,71584
5479,5479,409,2007-04-20 19:53:00,12.116.162.162,1,2007,71585
5480,5480,408,2007-04-20 19:55:00,Sfmammamia,-298,2007,71287
5481,5481,405,2007-04-20 19:57:00,80.47.229.161,-50,2007,71237
5482,5482,407,2007-04-20 19:57:00,68.19.88.80,0,2007,71237
5483,5483,406,2007-04-20 19:57:00,MartinBot,0,2007,71237
5484,5484,404,2007-04-20 19:58:00,Moreschi,50,2007,71287
5485,5485,403,2007-04-20 20:02:00,68.19.88.80,0,2007,71287
5486,5486,402,2007-04-20 20:03:00,Zzuuzz,0,2007,71287
5487,5487,401,2007-04-20 20:11:00,67.52.184.2,99,2007,71386
5488,5488,400,2007-04-20 20:11:00,Zscout370,-99,2007,71287
5489,5489,399,2007-04-20 20:12:00,72.196.201.180,362,2007,71649
5490,5490,398,2007-04-20 20:13:00,Moreschi,-362,2007,71287
5491,5491,397,2007-04-20 20:15:00,Fizbin,0,2007,71287
5492,5492,396,2007-04-20 20:16:00,Jambalaya~enwiki,0,2007,71287
5493,5493,395,2007-04-20 20:17:00,Sad mouse,0,2007,71287
5494,5494,394,2007-04-20 20:18:00,Lapinmies,217,2007,71504
5495,5495,393,2007-04-20 20:19:00,ElKevbo,-217,2007,71287
5496,5496,392,2007-04-20 20:20:00,The Placebo Effect,0,2007,71287
5497,5497,391,2007-04-20 20:21:00,209.247.22.45,-394,2007,70893
5498,5498,390,2007-04-20 20:22:00,62.234.22.136,12,2007,70905
5499,5499,389,2007-04-20 20:23:00,Lapinmies,264,2007,71169
5500,5500,388,2007-04-20 20:23:00,Nakon,-276,2007,70893
5501,5501,387,2007-04-20 20:25:00,Pladuk,153,2007,71046
5502,5502,386,2007-04-20 20:29:00,128.164.240.94,397,2007,71443
5503,5503,385,2007-04-20 20:30:00,Lapinmies,264,2007,71707
5504,5504,384,2007-04-20 20:30:00,Mytwocents,4,2007,71711
5505,5505,383,2007-04-20 20:34:00,128.164.240.94,29,2007,71740
5506,5506,382,2007-04-20 20:35:00,Kurtkowalchuk,17,2007,71757
5507,5507,381,2007-04-20 20:36:00,Moreschi,-17,2007,71740
5508,5508,380,2007-04-20 20:37:00,128.164.240.94,47,2007,71787
5509,5509,379,2007-04-20 20:39:00,128.164.240.94,11,2007,71798
5510,5510,378,2007-04-20 20:41:00,Kurtkowalchuk,18,2007,71816
5511,5511,377,2007-04-20 20:42:00,Mathteacher1729,-18,2007,71798
5512,5512,376,2007-04-20 20:46:00,Kurtkowalchuk,186,2007,71984
5513,5513,375,2007-04-20 20:48:00,Moreschi,-186,2007,71798
5514,5514,374,2007-04-20 20:58:00,Caerwine,7,2007,71805
5515,5515,373,2007-04-20 21:06:00,A Train,0,2007,71805
5516,5516,372,2007-04-20 21:08:00,Markm62,-48,2007,71757
5517,5517,371,2007-04-20 21:11:00,De Administrando Imperio,-10,2007,71747
5518,5518,370,2007-04-20 21:11:00,De Administrando Imperio,0,2007,71747
5519,5520,368,2007-04-20 21:12:00,Markm62,24,2007,71771
5520,5519,369,2007-04-20 21:12:00,Ronnotel,-264,2007,71507
5521,5521,367,2007-04-20 21:18:00,Wadems,-1,2007,71506
5522,5522,366,2007-04-20 21:19:00,Markm62,-2,2007,71504
5523,5523,365,2007-04-20 21:21:00,Sfmammamia,1,2007,71505
5524,5524,364,2007-04-20 21:22:00,Mlscdi,99,2007,71604
5525,5525,363,2007-04-20 21:29:00,Mycota,8,2007,71612
5526,5526,362,2007-04-20 21:40:00,Gdo01,-15,2007,71597
5527,5527,361,2007-04-20 21:41:00,Ixfd64,0,2007,71597
5528,5528,360,2007-04-20 21:41:00,69.149.228.226,196,2007,71793
5529,5529,359,2007-04-20 21:42:00,Nakon,-196,2007,71597
5530,5530,358,2007-04-20 21:42:00,129.42.208.182,-4,2007,71593
5531,5531,357,2007-04-20 22:07:00,Swatjester,295,2007,71888
5532,5532,356,2007-04-20 22:11:00,Mycota,0,2007,71888
5533,5533,354,2007-04-20 22:12:00,Uriel8,145,2007,72033
5534,5534,355,2007-04-20 22:12:00,Rooot,0,2007,72033
5535,5535,353,2007-04-20 22:16:00,24.251.213.139,19,2007,72052
5536,5536,352,2007-04-20 22:18:00,Sfmammamia,-326,2007,71726
5537,5537,351,2007-04-20 22:18:00,Rooot,51,2007,71777
5538,5538,350,2007-04-20 22:21:00,Rooot,0,2007,71777
5539,5539,349,2007-04-20 22:24:00,72.222.215.247,107,2007,71884
5540,5540,348,2007-04-20 22:25:00,Uriel8,88,2007,71972
5541,5541,347,2007-04-20 22:26:00,71.120.6.108,-56,2007,71916
5542,5543,345,2007-04-20 22:27:00,71.159.137.161,60,2007,71976
5543,5542,346,2007-04-20 22:27:00,Uriel8,134,2007,72110
5544,5544,344,2007-04-20 22:28:00,Cool Blue,-60,2007,72050
5545,5545,343,2007-04-20 22:29:00,Sfmammamia,-36,2007,72014
5546,5546,342,2007-04-20 22:32:00,Tvoz,407,2007,72421
5547,5547,341,2007-04-20 22:32:00,Community editor,0,2007,72421
5548,5548,340,2007-04-20 22:36:00,Community editor,133,2007,72554
5549,5549,339,2007-04-20 22:37:00,195.56.91.23,248,2007,72802
5550,5550,338,2007-04-20 22:38:00,195.56.91.23,15,2007,72817
5551,5551,337,2007-04-20 22:39:00,Reisio,-41,2007,72776
5552,5552,336,2007-04-20 22:48:00,Reisio,-1,2007,72775
5553,5553,335,2007-04-20 22:53:00,Sfmammamia,-352,2007,72423
5554,5556,333,2007-04-20 22:56:00,Crunch,2,2007,72425
5555,5554,332,2007-04-20 22:56:00,Sportsandweatherfreak,167,2007,72592
5556,5555,334,2007-04-20 22:56:00,Crunch,20,2007,72612
5557,5557,331,2007-04-20 22:58:00,Crunch,0,2007,72612
5558,5558,330,2007-04-20 23:00:00,Gdo01,-5,2007,72607
5559,5559,329,2007-04-20 23:01:00,204.42.27.110,-245,2007,72362
5560,5560,328,2007-04-20 23:06:00,Natalie Erin,245,2007,72607
5561,5561,327,2007-04-20 23:06:00,T-Z-M,119,2007,72726
5562,5562,326,2007-04-22 00:00:00,74.101.6.41,17,2007,72743
5563,5563,325,2007-04-22 00:01:00,M C Y 1008,-17,2007,72726
5564,5564,324,2007-04-22 00:10:00,74.101.6.41,-18,2007,72708
5565,5565,323,2007-04-22 00:18:00,66.183.92.54,200,2007,72908
5566,5566,322,2007-04-22 00:25:00,ElKevbo,-200,2007,72708
5567,5567,321,2007-04-22 00:27:00,75.47.141.203,0,2007,72708
5568,5568,320,2007-04-22 00:28:00,ElKevbo,32,2007,72740
5569,5569,319,2007-04-22 00:30:00,ElKevbo,4,2007,72744
5570,5570,318,2007-04-22 00:39:00,199.18.239.3,38,2007,72782
5571,5571,317,2007-04-22 00:49:00,RoyBoy,-1,2007,72781
5572,5572,316,2007-04-22 00:50:00,198.82.86.171,70,2007,72851
5573,5573,315,2007-04-22 00:51:00,RoyBoy,-20,2007,72831
5574,5574,314,2007-04-22 01:02:00,203.206.238.112,-36,2007,72795
5575,5575,313,2007-04-22 01:05:00,Natalie Erin,0,2007,72795
5576,5576,312,2007-04-22 01:25:00,RoyBoy,-1,2007,72794
5577,5577,311,2007-04-22 01:36:00,AceYYC,4,2007,72798
5578,5578,310,2007-04-22 01:40:00,RoyBoy,10,2007,72808
5579,5579,309,2007-04-22 01:59:00,Kransky,0,2007,72808
5580,5580,308,2007-04-22 02:04:00,66.66.69.56,64,2007,72872
5581,5581,307,2007-04-22 02:06:00,66.66.69.56,13,2007,72885
5582,5582,306,2007-04-22 02:07:00,Szyslak,-13,2007,72872
5583,5583,305,2007-04-22 02:08:00,Szyslak,-64,2007,72808
5584,5584,304,2007-04-22 02:15:00,69.19.14.38,26,2007,72834
5585,5585,303,2007-04-22 02:16:00,Irish Pearl,-26,2007,72808
5586,5586,302,2007-04-22 02:16:00,71.36.128.30,-4,2007,72804
5587,5587,301,2007-04-22 02:18:00,69.19.14.38,15,2007,72819
5588,5588,300,2007-04-22 02:19:00,Irish Pearl,-15,2007,72804
5589,5589,299,2007-04-22 02:23:00,JKrantoski,0,2007,72804
5590,5590,298,2007-04-22 02:28:00,72.196.114.56,19,2007,72823
5591,5591,297,2007-04-22 02:29:00,Morphh,1,2007,72824
5592,5592,295,2007-04-22 02:31:00,Natalie Erin,0,2007,72824
5593,5593,296,2007-04-22 02:31:00,Ronnotel,4,2007,72828
5594,5594,294,2007-04-22 02:34:00,Natalie Erin,0,2007,72828
5595,5595,293,2007-04-22 03:13:00,68.53.34.3,12,2007,72840
5596,5596,292,2007-04-22 03:15:00,Zzuuzz,-12,2007,72828
5597,5597,291,2007-04-22 03:23:00,68.53.34.3,-24,2007,72804
5598,5599,289,2007-04-22 03:25:00,68.53.34.3,-8,2007,72796
5599,5598,290,2007-04-22 03:25:00,TeaDrinker,24,2007,72820
5600,5600,288,2007-04-22 03:26:00,LuigiManiac,8,2007,72828
5601,5601,287,2007-04-22 03:29:00,YonaBot,56,2007,72884
5602,5602,285,2007-04-22 03:30:00,David Shankbone,66,2007,72950
5603,5603,286,2007-04-22 03:30:00,B,-66,2007,72884
5604,5604,284,2007-04-22 03:34:00,69.118.129.76,5,2007,72889
5605,5605,283,2007-04-22 03:36:00,69.118.129.76,-47,2007,72842
5606,5606,280,2007-04-22 03:38:00,58.162.53.194,173,2007,73015
5607,5607,282,2007-04-22 03:38:00,69.118.129.76,0,2007,73015
5608,5608,281,2007-04-22 03:38:00,Zzuuzz,42,2007,73057
5609,5609,279,2007-04-22 03:39:00,Czj,-173,2007,72884
5610,5610,278,2007-04-22 03:41:00,76.185.46.78,0,2007,72884
5611,5611,277,2007-04-22 03:43:00,GGreeneVa,0,2007,72884
5612,5612,276,2007-04-22 03:46:00,JGHowes,32,2007,72916
5613,5613,275,2007-04-22 03:50:00,24.124.88.192,0,2007,72916
5614,5614,274,2007-04-22 03:52:00,David Shankbone,-66,2007,72850
5615,5615,273,2007-04-22 03:52:00,GGreeneVa,0,2007,72850
5616,5616,272,2007-04-22 03:53:00,24.124.88.192,0,2007,72850
5617,5617,271,2007-04-22 03:54:00,GGreeneVa,-66,2007,72784
5618,5618,270,2007-04-22 03:59:00,GGreeneVa,0,2007,72784
5619,5619,268,2007-04-22 04:00:00,MartinBot,0,2007,72784
5620,5620,269,2007-04-22 04:00:00,72.75.150.178,0,2007,72784
5621,5623,265,2007-04-22 04:02:00,Fundamental metric tensor,0,2007,72784
5622,5622,266,2007-04-22 04:02:00,Rklawton,0,2007,72784
5623,5621,267,2007-04-22 04:02:00,24.124.88.192,0,2007,72784
5624,5624,264,2007-04-22 04:03:00,Rklawton,0,2007,72784
5625,5625,263,2007-04-22 04:05:00,24.124.88.192,0,2007,72784
5626,5626,262,2007-04-24 00:16:00,VBGFscJUn3,5,2007,72789
5627,5627,261,2007-04-24 01:50:00,Sfmammamia,20,2007,72809
5628,5628,260,2007-04-24 01:53:00,Sfmammamia,-59,2007,72750
5629,5629,259,2007-04-24 02:14:00,Ohconfucius,0,2007,72750
5630,5630,258,2007-04-24 02:28:00,Natalie Erin,-1,2007,72749
5631,5631,257,2007-04-24 02:38:00,Penser,468,2007,73217
5632,5632,256,2007-04-24 02:49:00,Natalie Erin,138,2007,73355
5633,5633,255,2007-04-24 02:50:00,Natalie Erin,2,2007,73357
5634,5634,254,2007-04-24 02:51:00,WhisperToMe,-9,2007,73348
5635,5635,253,2007-04-24 02:57:00,Horace Horatius,277,2007,73625
5636,5636,252,2007-04-24 03:00:00,Ohconfucius,-396,2007,73229
5637,5637,251,2007-04-24 03:03:00,Ohconfucius,-91,2007,73138
5638,5638,250,2007-04-24 03:06:00,Ohconfucius,-12,2007,73126
5639,5639,249,2007-04-24 03:10:00,Ohconfucius,-272,2007,72854
5640,5640,248,2007-04-24 03:13:00,Deltabeignet,1,2007,72855
5641,5641,246,2007-04-24 03:18:00,Davecullen,371,2007,73226
5642,5642,247,2007-04-24 03:18:00,Ohconfucius,0,2007,73226
5643,5643,245,2007-04-24 03:22:00,Ohconfucius,-413,2007,72813
5644,5644,244,2007-04-24 03:23:00,Jberr011,0,2007,72813
5645,5645,243,2007-04-24 03:24:00,Jberr011,2,2007,72815
5646,5646,242,2007-04-24 03:26:00,Jberr011,10,2007,72825
5647,5647,241,2007-04-24 03:28:00,Mytwocents,-58,2007,72767
5648,5648,240,2007-04-24 03:30:00,Ohconfucius,0,2007,72767
5649,5649,239,2007-04-24 03:35:00,Ohconfucius,0,2007,72767
5650,5650,238,2007-04-24 03:37:00,Ohconfucius,-43,2007,72724
5651,5651,237,2007-04-24 03:38:00,Ohconfucius,-70,2007,72654
5652,5652,235,2007-04-24 03:40:00,Ohconfucius,14,2007,72668
5653,5653,236,2007-04-24 03:40:00,Jberr011,47,2007,72715
5654,5654,234,2007-04-24 03:42:00,Anchoress,0,2007,72715
5655,5655,233,2007-04-24 03:44:00,Ohconfucius,-51,2007,72664
5656,5658,232,2007-04-24 03:46:00,Sfmammamia,63,2007,72727
5657,5657,230,2007-04-24 03:46:00,Wahkeenah,500,2007,73227
5658,5656,231,2007-04-24 03:46:00,Ohconfucius,-15,2007,73212
5659,5659,229,2007-04-24 03:47:00,Sfmammamia,-1,2007,73211
5660,5660,228,2007-04-24 04:00:00,Sfmammamia,9,2007,73220
5661,5661,227,2007-04-24 04:06:00,Sfmammamia,6,2007,73226
5662,5662,226,2007-04-24 04:10:00,Sfmammamia,1,2007,73227
5663,5663,225,2007-04-24 04:18:00,Mayorcheese,6,2007,73233
5664,5664,224,2007-04-24 04:24:00,Sfmammamia,36,2007,73269
5665,5665,223,2007-04-24 04:35:00,Amcbride,-3,2007,73266
5666,5666,222,2007-04-24 05:17:00,Sfmammamia,5,2007,73271
5667,5667,221,2007-04-24 07:04:00,Gbo2k6,177,2007,73448
5668,5668,220,2007-04-24 08:14:00,155.69.5.235,9,2007,73457
5669,5669,219,2007-04-24 08:17:00,155.69.5.235,24,2007,73481
5670,5670,218,2007-04-24 08:19:00,El C,-33,2007,73448
5671,5671,217,2007-04-24 08:19:00,155.69.5.235,12,2007,73460
5672,5672,216,2007-04-24 08:19:00,El C,-12,2007,73448
5673,5673,215,2007-04-24 08:36:00,Stemonitis,33,2007,73481
5674,5674,214,2007-04-24 08:51:00,24.20.69.240,-7,2007,73474
5675,5675,213,2007-04-24 09:20:00,Chaerani,0,2007,73474
5676,5676,212,2007-04-24 09:26:00,Chuq,-376,2007,73098
5677,5677,211,2007-04-24 09:53:00,61.5.146.126,-39,2007,73059
5678,5678,210,2007-04-24 09:53:00,61.5.146.126,1,2007,73060
5679,5679,209,2007-04-24 10:04:00,203.111.237.12,1,2007,73061
5680,5680,208,2007-04-24 10:06:00,81.174.24.61,0,2007,73061
5681,5681,207,2007-04-24 10:10:00,Riana,-32,2007,73029
5682,5682,206,2007-04-24 10:14:00,Valentinian,-1,2007,73028
5683,5683,205,2007-04-24 10:16:00,CJ,36,2007,73064
5684,5684,204,2007-04-24 10:38:00,M a s,1,2007,73065
5685,5685,203,2007-04-24 11:06:00,Abe Lincoln,36,2007,73101
5686,5686,202,2007-04-24 11:10:00,Svetovid,0,2007,73101
5687,5687,201,2007-04-24 11:11:00,Svetovid,-244,2007,72857
5688,5688,200,2007-04-24 11:14:00,Penser,333,2007,73190
5689,5689,199,2007-04-24 12:02:00,128.130.205.17,0,2007,73190
5690,5690,198,2007-04-24 12:06:00,128.130.205.17,96,2007,73286
5691,5691,197,2007-04-24 12:08:00,Ps653,0,2007,73286
5692,5692,196,2007-04-24 12:09:00,128.130.205.17,49,2007,73335
5693,5693,195,2007-04-24 12:10:00,Ps653,-49,2007,73286
5694,5694,194,2007-04-24 12:12:00,128.130.205.17,0,2007,73286
5695,5695,193,2007-04-24 12:12:00,Riana,0,2007,73286
5696,5696,192,2007-04-24 12:23:00,71.111.210.246,3,2007,73289
5697,5697,191,2007-04-24 12:44:00,ElKevbo,0,2007,73289
5698,5698,190,2007-04-24 12:58:00,Kevinp2,305,2007,73594
5699,5699,189,2007-04-24 12:59:00,216.120.135.222,-5,2007,73589
5700,5700,186,2007-04-24 13:00:00,Kevinp2,0,2007,73589
5701,5701,188,2007-04-24 13:00:00,HokieRNB,5,2007,73594
5702,5702,187,2007-04-24 13:00:00,Felixboy,9,2007,73603
5703,5703,185,2007-04-24 13:07:00,HokieRNB,0,2007,73603
5704,5704,184,2007-04-24 13:39:00,64.131.205.111,403,2007,74006
5705,5705,183,2007-04-24 13:43:00,64.131.205.111,4,2007,74010
5706,5706,182,2007-04-24 13:59:00,Salamurai,-4,2007,74006
5707,5707,181,2007-04-24 14:01:00,Gokustyle667,31,2007,74037
5708,5708,180,2007-04-24 14:09:00,CJinoz,-31,2007,74006
5709,5709,179,2007-04-24 14:12:00,Kevinp2,37,2007,74043
5710,5710,178,2007-04-24 14:15:00,Kevinp2,67,2007,74110
5711,5711,177,2007-04-24 14:35:00,205.143.204.206,-28,2007,74082
5712,5712,176,2007-04-24 14:35:00,Sfmammamia,2,2007,74084
5713,5713,175,2007-04-24 14:37:00,B,13,2007,74097
5714,5715,174,2007-04-24 14:38:00,B,-2,2007,74095
5715,5714,173,2007-04-24 14:38:00,67.184.156.250,101,2007,74196
5716,5716,172,2007-04-24 14:39:00,B,-101,2007,74095
5717,5717,171,2007-04-24 14:40:00,67.184.156.250,101,2007,74196
5718,5718,170,2007-04-24 14:43:00,Sfmammamia,-103,2007,74093
5719,5719,169,2007-04-24 14:45:00,Sfmammamia,-71,2007,74022
5720,5720,168,2007-04-24 14:46:00,B,-101,2007,73921
5721,5721,167,2007-04-24 14:47:00,164.107.223.217,277,2007,74198
5722,5722,166,2007-04-24 14:47:00,Sfmammamia,-14,2007,74184
5723,5723,165,2007-04-24 14:50:00,Ronnotel,-76,2007,74108
5724,5724,164,2007-04-24 14:52:00,Darker Dreams,0,2007,74108
5725,5725,163,2007-04-24 14:53:00,Ronnotel,40,2007,74148
5726,5726,162,2007-04-24 14:54:00,Ronnotel,31,2007,74179
5727,5727,161,2007-04-24 14:56:00,Rich Farmbrough,144,2007,74323
5728,5728,160,2007-04-24 14:57:00,Rich Farmbrough,0,2007,74323
5729,5729,159,2007-04-24 15:02:00,Sfmammamia,327,2007,74650
5730,5730,158,2007-04-24 15:13:00,205.221.92.9,-26,2007,74624
5731,5731,157,2007-04-24 15:15:00,Moreschi,26,2007,74650
5732,5732,156,2007-04-24 15:18:00,Sfmammamia,0,2007,74650
5733,5733,155,2007-04-24 15:27:00,Benabik,-7,2007,74643
5734,5734,154,2007-04-24 15:38:00,Benabik,171,2007,74814
5735,5735,153,2007-04-24 15:42:00,80.124.149.170,0,2007,74814
5736,5736,152,2007-04-24 15:47:00,Moreschi,0,2007,74814
5737,5737,151,2007-04-24 15:56:00,Tpbradbury,2,2007,74816
5738,5738,150,2007-04-24 16:08:00,Tpbradbury,0,2007,74816
5739,5739,149,2007-04-24 16:30:00,Bishwa s,145,2007,74961
5740,5740,148,2007-04-24 16:33:00,209.7.158.3,147,2007,75108
5741,5741,147,2007-04-24 16:34:00,67.166.164.194,15,2007,75123
5742,5742,146,2007-04-24 16:36:00,ElKevbo,-147,2007,74976
5743,5743,145,2007-04-24 16:43:00,Pyrospirit,0,2007,74976
5744,5744,144,2007-04-24 16:53:00,71.252.203.21,259,2007,75235
5745,5745,143,2007-04-24 17:05:00,Kevinp2,-179,2007,75056
5746,5746,142,2007-04-24 17:12:00,Kevinp2,-410,2007,74646
5747,5747,141,2007-04-24 17:36:00,Gbo2k6,4,2007,74650
5748,5749,140,2007-04-24 17:37:00,71.166.165.83,4,2007,74654
5749,5748,139,2007-04-24 17:37:00,Gbo2k6,25,2007,74679
5750,5750,138,2007-04-24 17:40:00,Jesant13,24,2007,74703
5751,5751,137,2007-04-24 17:45:00,Sandover,310,2007,75013
5752,5752,136,2007-04-24 17:50:00,Threeafterthree,0,2007,75013
5753,5753,135,2007-04-24 17:53:00,PRRfan,-8,2007,75005
5754,5754,134,2007-04-24 17:53:00,Ronnotel,-65,2007,74940
5755,5755,133,2007-04-24 17:55:00,Ronnotel,4,2007,74944
5756,5756,132,2007-04-24 18:01:00,169.204.228.230,1,2007,74945
5757,5757,131,2007-04-24 18:01:00,169.204.228.230,2,2007,74947
5758,5758,130,2007-04-24 18:01:00,Moreschi,-3,2007,74944
5759,5759,129,2007-04-24 18:06:00,PRRfan,-55,2007,74889
5760,5760,128,2007-04-24 18:07:00,205.125.21.109,0,2007,74889
5761,5761,127,2007-04-24 18:08:00,PRRfan,-22,2007,74867
5762,5762,126,2007-04-24 18:17:00,Bear475,0,2007,74867
5763,5763,125,2007-04-24 18:19:00,65.111.217.137,70,2007,74937
5764,5764,124,2007-04-24 18:20:00,65.111.217.137,-13,2007,74924
5765,5765,123,2007-04-24 18:22:00,65.111.217.137,68,2007,74992
5766,5766,122,2007-04-24 18:22:00,Retired username,-125,2007,74867
5767,5767,121,2007-04-24 18:38:00,Sfmammamia,-32,2007,74835
5768,5768,120,2007-04-24 18:45:00,BostonRed,8,2007,74843
5769,5769,119,2007-04-24 18:48:00,Sfmammamia,-12,2007,74831
5770,5770,118,2007-04-24 18:54:00,198.82.73.153,25,2007,74856
5771,5772,117,2007-04-24 18:58:00,Kkychina,-151,2007,74705
5772,5771,116,2007-04-24 18:58:00,65.214.112.56,398,2007,75103
5773,5773,115,2007-04-24 19:00:00,B,-105,2007,74998
5774,5774,114,2007-04-24 19:06:00,Chaser,-1,2007,74997
5775,5775,113,2007-04-24 19:36:00,65.93.19.90,0,2007,74997
5776,5776,112,2007-04-24 19:36:00,Chrislk02,0,2007,74997
5777,5777,111,2007-04-24 20:06:00,Youngidealist,0,2007,74997
5778,5778,110,2007-04-24 20:15:00,128.135.96.177,-288,2007,74709
5779,5779,109,2007-04-24 20:19:00,69.255.190.96,105,2007,74814
5780,5780,108,2007-04-24 20:20:00,MartinBot,-105,2007,74709
5781,5781,107,2007-04-24 20:26:00,65.31.162.230,0,2007,74709
5782,5783,106,2007-04-24 20:27:00,Delldot,0,2007,74709
5783,5782,105,2007-04-24 20:27:00,Ashoup,127,2007,74836
5784,5784,104,2007-04-24 20:32:00,Yaf,-14,2007,74822
5785,5785,103,2007-04-24 20:33:00,Wrad,-1,2007,74821
5786,5786,102,2007-04-24 20:37:00,Jared,0,2007,74821
5787,5787,101,2007-04-24 20:38:00,Coemgenus,-17,2007,74804
5788,5788,100,2007-04-24 20:39:00,Coemgenus,-10,2007,74794
5789,5789,99,2007-04-24 20:43:00,Ronnotel,14,2007,74808
5790,5790,98,2007-04-24 21:01:00,Naus,-1,2007,74807
5791,5791,97,2007-04-24 21:07:00,Naus,6,2007,74813
5792,5792,96,2007-04-24 21:15:00,Naus,38,2007,74851
5793,5793,95,2007-04-24 21:19:00,Sfmammamia,-2,2007,74849
5794,5794,94,2007-04-24 21:20:00,Sfmammamia,1,2007,74850
5795,5795,93,2007-04-24 21:25:00,Ronnotel,-18,2007,74832
5796,5796,92,2007-04-24 21:28:00,66.57.118.48,492,2007,75324
5797,5797,90,2007-04-24 21:29:00,Giaour9,141,2007,75465
5798,5798,91,2007-04-24 21:29:00,Natalie Erin,-492,2007,74973
5799,5799,89,2007-04-24 21:31:00,Sfmammamia,-141,2007,74832
5800,5800,88,2007-04-24 21:38:00,WhisperToMe,0,2007,74832
5801,5801,87,2007-04-24 21:39:00,Mahagaja,-1,2007,74831
5802,5802,86,2007-04-24 21:41:00,WhisperToMe,300,2007,75131
5803,5803,85,2007-04-24 21:47:00,68.26.242.194,116,2007,75247
5804,5804,84,2007-04-24 21:49:00,68.26.242.194,24,2007,75271
5805,5805,83,2007-04-24 21:59:00,El C,-140,2007,75131
5806,5806,82,2007-04-24 22:09:00,ElKevbo,-1,2007,75130
5807,5807,81,2007-04-24 22:24:00,Alucard51717,-3,2007,75127
5808,5808,80,2007-04-24 22:25:00,76.21.163.65,65,2007,75192
5809,5809,78,2007-04-24 22:27:00,Alucard51717,0,2007,75192
5810,5810,77,2007-04-24 22:27:00,Alucard51717,65,2007,75257
5811,5811,79,2007-04-24 22:27:00,El C,-65,2007,75192
5812,5812,76,2007-04-24 22:28:00,Drunkenmonkey,-65,2007,75127
5813,5813,75,2007-04-24 22:30:00,Drunkenmonkey,0,2007,75127
5814,5814,74,2007-04-24 22:38:00,Logical Argument,17,2007,75144
5815,5815,73,2007-04-24 22:46:00,TimVickers,134,2007,75278
5816,5816,72,2007-04-24 22:47:00,TimVickers,-19,2007,75259
5817,5817,71,2007-04-24 22:49:00,TimVickers,87,2007,75346
5818,5818,70,2007-04-24 22:50:00,Matsuda~enwiki,73,2007,75419
5819,5819,69,2007-04-24 22:56:00,El C,-73,2007,75346
5820,5820,68,2007-04-24 23:10:00,TimothyChenAllen,3,2007,75349
5821,5821,67,2007-04-24 23:20:00,WhisperToMe,-32,2007,75317
5822,5822,65,2007-04-24 23:21:00,WhisperToMe,54,2007,75371
5823,5823,66,2007-04-24 23:21:00,70.0.246.107,125,2007,75496
5824,5824,64,2007-05-01 01:02:00,Sonachowdhary4,73,2007,75569
5825,5825,63,2007-05-01 01:05:00,Sonachowdhary4,47,2007,75616
5826,5826,62,2007-05-01 01:13:00,Sfmammamia,-73,2007,75543
5827,5827,61,2007-05-01 01:14:00,Sfmammamia,-47,2007,75496
5828,5828,60,2007-05-01 01:35:00,204.111.144.162,-1,2007,75495
5829,5829,59,2007-05-01 01:36:00,204.111.144.162,-2,2007,75493
5830,5830,58,2007-05-01 01:40:00,Loren36,3,2007,75496
5831,5831,57,2007-05-01 02:22:00,72.229.130.76,152,2007,75648
5832,5832,56,2007-05-01 02:28:00,72.229.130.76,72,2007,75720
5833,5833,55,2007-05-01 02:29:00,72.229.130.76,-66,2007,75654
5834,5834,54,2007-05-01 02:49:00,B,-5,2007,75649
5835,5835,53,2007-05-01 02:50:00,TAnthony,-153,2007,75496
5836,5836,52,2007-05-01 03:00:00,76.108.112.78,3,2007,75499
5837,5837,51,2007-05-01 03:05:00,76.108.112.78,40,2007,75539
5838,5838,50,2007-05-01 03:06:00,AceYYC,-43,2007,75496
5839,5839,49,2007-05-01 03:32:00,24.4.45.75,-67,2007,75429
5840,5840,48,2007-05-01 03:32:00,Burntapple,11,2007,75440
5841,5841,47,2007-05-01 03:33:00,Phony Saint,67,2007,75507
5842,5842,46,2007-05-01 04:06:00,Chobot,-48,2007,75459
5843,5843,44,2007-05-01 04:18:00,Nivix,7,2007,75466
5844,5844,45,2007-05-01 04:18:00,66.223.211.154,-7,2007,75459
5845,5845,43,2007-05-01 04:42:00,Yaf,-1,2007,75458
5846,5846,42,2007-05-01 04:43:00,Yaf,-8,2007,75450
5847,5847,41,2007-05-01 04:46:00,Yaf,-8,2007,75442
5848,5848,40,2007-05-01 04:47:00,Yaf,-4,2007,75438
5849,5849,39,2007-05-01 04:48:00,Yaf,1,2007,75439
5850,5850,38,2007-05-01 04:49:00,Yaf,1,2007,75440
5851,5851,37,2007-05-01 04:51:00,Yaf,-4,2007,75436
5852,5852,36,2007-05-01 05:00:00,Yaf,0,2007,75436
5853,5853,35,2007-05-01 05:08:00,Sfmammamia,-12,2007,75424
5854,5854,34,2007-05-11 00:26:00,WhisperToMe,296,2007,75720
5855,5855,33,2007-07-01 05:48:00,69.19.14.15,-7,2007,75713
5856,5856,32,2007-07-01 06:17:00,Pseudo-Richard,21,2007,75734
5857,5857,31,2007-07-01 07:01:00,Pseudo-Richard,-16,2007,75718
5858,5858,30,2007-10-04 13:46:00,75.144.80.177,-8,2007,75710
5859,5859,29,2008-02-27 03:24:00,99.135.89.196,6,2008,75716
5860,5860,28,2008-02-27 03:30:00,Sfmammamia,-6,2008,75710
5861,5861,27,2008-04-24 02:11:00,98.212.164.95,-123,2008,75587
5862,5862,26,2008-04-24 12:56:00,HokieRNB,123,2008,75710
5863,5863,25,2008-04-24 15:54:00,164.58.68.3,24,2008,75734
5864,5864,24,2008-04-24 15:55:00,Toddst1,-24,2008,75710
5865,5865,22,2008-04-24 15:56:00,JSpung,-44,2008,75666
5866,5866,23,2008-04-24 15:56:00,164.58.68.3,44,2008,75710
5867,5867,21,2008-04-24 16:09:00,Toddst1,0,2008,75710
5868,5868,20,2009-04-18 04:04:00,69.112.73.138,-410,2009,75300
5869,5869,19,2009-04-18 04:05:00,69.112.73.138,0,2009,75300
5870,5870,18,2009-04-18 04:05:00,Backslash Forwardslash,0,2009,75300
5871,5871,17,2009-04-18 21:24:00,76.69.64.8,0,2009,75300
5872,5872,16,2009-04-18 21:51:00,ElKevbo,0,2009,75300
5873,5873,15,2009-04-18 23:01:00,76.234.226.107,0,2009,75300
5874,5874,14,2010-09-30 00:18:00,76.242.8.108,0,2010,75300
5875,5875,13,2010-09-30 00:51:00,HokieRNB,0,2010,75300
5876,5876,12,2010-09-30 10:40:00,BrownHairedGirl,-30,2010,75270
5877,5877,11,2010-09-30 13:24:00,208.67.140.193,24,2010,75294
5878,5878,10,2010-09-30 13:31:00,208.67.140.193,30,2010,75324
5879,5879,9,2010-09-30 13:33:00,208.67.140.193,-53,2010,75271
5880,5880,8,2010-09-30 14:06:00,208.67.140.193,65,2010,75336
5881,5881,7,2010-09-30 14:15:00,ElKevbo,-66,2010,75270
5882,5882,6,2012-12-16 02:34:00,MZMcBride,0,2012,75270
5883,5883,5,2012-12-16 04:00:00,98.82.27.111,5,2012,75275
5884,5884,4,2012-12-16 05:41:00,MZMcBride,-5,2012,75270
5885,5885,3,2012-12-16 07:51:00,HandsomeFella,1,2012,75271
5886,5886,2,2012-12-16 08:59:00,Hmains,-1,2012,75270
5887,5887,1,2012-12-16 09:58:00,76.88.39.206,7,2012,75277
5888,5888,0,2014-09-24 21:04:00,Titanium Dragon,-112,2014,75165
